/*
Created by Aleksandr Fedchin on 21/11/2018.
This is the complete scansion of trimeter sections of Seneca's Agamemnon
The edition used is that of O. Zwierlein, 1986, source:mqdq.it
MqDq version was modified whenever there were typos (line 545).
Estimated accuracy: 98%

Each line contains a verse from the original text, a list of words from that
verse with their inferred scansions, the scansion itself, and one of the
following tags:
    'm' - if the line was manually scanned
    'v' - if automatically produced scansion was manually verified
    'c' - if automatically produced scansion was corrected
    'u' - if the line was left unscanned
    confidence score that the program assigns to the line (higher=better)

Key:
X - monosyllabic anceps (can also be marked as _ or ^ wherever the line is
	scanned manually)
_ - long syllable
^ - short syllable
& - the quantity is unknown (for elided syllables, anceps syllables,
	or syllables long by position)
Resolution rate: 0.855
Resolution rate in lines in which speakers remain the same: 0.848
Resolution rate in lines in which speakers change: 1.105
*/

Opaca linquens Ditis inferni loca,	o&pa_ca^ li_nqve&ns di_ti^s i_nfe&rni_ lo^ca& 	X_^_X_^_X_^X	1.0
Adsum profundo Tartari emissus specu,	a&dsu&m pro^fu_ndo& ta_rta^ri& e_mi&ssu&s spe^cu& 	X_^_X_^_X_^X	1.0
Incertus utras oderim sedes magis:	i_nce_rtu^s u_tra&s o_de^ri&m s&ede&s ma^gi&s: 	X_^_X_^_X_^X	m
Fugio Thyestes inferos, superos fugo.	fu^gi^o_ thy^e_ste&s i_nfe^ro_s su^pe^ro&s fu^go& 	^^_^_X_^_^^_^X	1.0
En horret animus et pauor membra excutit:	e&n ho_rre^t a^ni^mu&s e&t pa^vo&r me&mbra& e_xcu^ti&t 	X_^^^X_^_X_^X	1.0
Video paternos, immo fraternos lares.	vi^de^o_ pa^te_rno&s i_mmo^ fra_te&rno&s la^re&s 	^^_^_X_^_X_^X	1.0
Hoc est uetustum Pelopiae limen domus;	ho&c e&st ve^tu_stu&m pe^lo^pi^[ae] li&me&n do^mu&s 	X_^_X^^^_X_^X	1.0
Hinc auspicari regium capiti decus	hi&nc [au]spi^ca_ri& re_gi^u&m ca^pi^ti_ de^cu&s 	X_^_X_^_^^_^X	1.0
Mos est Pelasgis, hoc sedent alti toro	mo&s e&st pe^la_sgi&s ho&c se^de&nt a&lti_ to^ro& 	X_^_X_^_X_^X	1.0
Quibus superba sceptra gestantur manu,	qvi&bu&s su^pe_rba& sce_ptra^ ge_sta&ntu&r ma^nu& 	X_^_X_^_X_^X	1.0
Locus hic habendae curiae - hic epulis locus.	lo^cu^s hi&c ha^be_ndae& cu_ri^ae& hi_c e^pu^li&s lo^cu&s	^^_^_X_^_^^_^X	m
Libet reuerti. nonne uel tristes lacus	li&be&t re^ve_rti& no_nne^ ve&l tri&ste&s la^cu&s 	X_^_X_^_X_^X	1.0
Incolere satius? nonne custodem Stygis	i&nco^le^re^ sa^ti^u&s no_nne^ cu_sto&de&m sty^gi&s 	X^^^^^X_^_X_^X	1.0
Trigemina nigris colla iactantem iubis	tri^ge^mi^na^ ni_gri&s co_lla^ ia_cta_nte_m iu^bi&s 	X^^^_X_^_X_^X	m
Vbi ille celeri corpus euinctus rotae	u&bi& i_lle^ ce^le^ri& co_rpu^s [eu]i&nctu&s ro^t[ae] 	X_^^^X_^_X_^X	1.0
In se refertur, ubi per aduersum irritus	i&n se_ re^fe_rtu&r u^bi^ pe^r a_dve&rsu&m i_rri^tu&s	X_^_X^^^_X_^X	m
Redeunte totiens luditur saxo labor,	re^de^u_nte^ to^ti^e&ns lu_di^tu&r sa&xo_ la^bo&r 	^^_^^^X_^_X_^X	0.97
Vbi tondet ales auida fecundum iecur,	u^bi^ to_nde^t a_le&s a^vi^da^ fe_cu&ndu&m je^cu&r 	^^_^_X^^^_X_^X	1.0
Et inter undas feruida exustus siti	e&t i_nte^r u_nda&s fe_rvi^da& e_xu&stu&s si^ti& 	X_^_X_^_X_^X	1.0
Aquas fugaces ore decepto appetit	a&qva&s fu^ga_ce&s o_re^ de_ce&pto& a_ppe^ti&t 	X_^_X_^_X_^X	1.0
Poenas daturus caelitum dapibus graues?	p[oe]na&s da^tu_ru&s c[ae]li^tu_m da^pi^bu&s gra^ve&s 	X_^_X_^_^^_^X	1.0
Sed ille nostrae pars quota est culpae senex?	se&d i_lle^ no_str[ae] pa&rs qvo^ta& e&st cu&lp[ae] se^ne&x 	X_^_X_^_X_^X	1.0
Reputemus omnes quos ob infandas manus	re^pu^te_mu^s o_mne&s qvo_s o^b i_nfa&nda&s ma^nu&s	^^_^_X_^_X_^X	m
Quaesitor urna Gnosius uersat reos:	qv[ae]si_to^r u_rna& gno_si^u&s ve&rsa&t re^o&s 	X_^_X_^_X_^X	1.0
Vincam Thyestes sceleribus cunctos meis.	vi&nca&m thy^e_ste&s sce^le^ri^bu_s cu&ncto&s me^i&s 	X_^_X^^^_X_^X	1.0
A fratre uincar? liberis plenus tribus	a& fra_tre^ vi_nca&r li_be^ri&s ple&nu&s tri^bu&s 	X_^_X_^_X_^X	1.0
In me sepultis? uiscera exedi mea.	i&n me_ se^pu_lti&s vi_sce^ra& e_xe&di_ me^a& 	X_^_X_^_X_^X	1.0
Nec hactenus Fortuna maculauit patrem,	ne&c ha_cte^nu&s fo&rtu_na^ ma^cu^l[au]i&t pa^tre&m 	X_^_X_^^^X_^X	0.71
Sed maius aliud ausa commisso scelus	se&d ma_ju^s a^li^u&d [au]sa^ co_mmi&sso& sce^lu&s 	X_^^^X_^_X_^X	1.0
Gnatae nefandos petere concubitus iubet.	gna&t[ae] ne^fa_ndo&s pe^te^re^ co_ncu^bi^tu&s ju^be&t 	X_^_X^^^_^^_^X	1.0
Non pauidus hausi dicta, sed cepi nefas.	no&n pa^vi^du^s h[au]si& di_cta^ se&d ce&pi_ ne^fa&s 	X^^^_X_^_X_^X	1.0
Ergo ut per omnis liberos irem parens,	e&rgo& u&t pe^r o_mni&s li_be^ro_s i&re&m pa^re&ns 	X_^_X_^_X_^X	0.97
Coacta fatis gnata fert utero graui	co&a_cta^ fa_ti&s gna_ta^ fe&rt u^te^ro& gra^vi& 	X_^_X_^_^^_^X	1.0
Me patre dignum. uersa natura est retro:	me& pa_tre^ di_gnu&m ve_rsa^ na_tu&ra& e&st re^tro& 	X_^_X_^_X_^X	0.24
Auo parentem, pro nefas, patri uirum,	a&vo_ pa^re_nte&m pro_ ne^fa&s pa&tri_ vi^ru&m 	X_^_X_^_X_^X	1.0
Gnatis nepotes miscui - nocti diem.	gna&ti&s ne^po_te&s mi_scu^i_ - no_cti_ di^e&m. 	X_^_X_^_X_^X	m
Sed sera tandem respicit fessos malis	se&d se_ra^ ta_nde&m re_spi^ci&t fe&sso&s ma^li&s 	X_^_X_^_X_^X	0.92
Post fata demum sortis incertae fides:	po&st fa_ta^ de_mu&m so_rti^s i_nce&rt[ae] fi^de&s 	X_^_X_^_X_^X	0.8
Rex ille regum, ductor Agamemnon ducum,	re&x i_lle^ re_gu&m du_cto^r a^ga^me&mno_n du^cu&m 	X_^_X_^^^X_^X	1.0
Cuius secutae mille uexillum rates	cu&ju&s se^cu_t[ae] mi_lle^ ve_xi&llu&m ra^te&s 	X_^_X_^_X_^X	1.0
Iliaca uelis maria texerunt suis,	i&li^a^ca^ ve_li&s ma^ri^a^ te_xe&ru&nt su^i&s 	X^^^_X^^^_X_^X	0.55
Post decima Phoebi lustra deuicto Ilio	po&st de^ci^ma^ ph[oe]bi& lu_stra^ d[eu]i&cto& i_li^o& 	X^^^_X_^_X_^X	1.0
Adest - daturus coniugi iugulum suae.	a&de&st da^tu_ru&s co_nju^gi_ ju^gu^lu&m su^[ae]	X_^_X_^_^^_^X	m
Iam iam natabit sanguine alterno domus:	ia&m ia&m na^ta_bi&t sa_ngui^ne& a_lte_rno_ do^mu&s: 	X_^_X_^_X_^X	m
Enses secures tela, diuisum graui	e&nse&s se^cu_re&s te_la^ di_vi&su&m gra^vi& 	X_^_X_^_X_^X	1.0
Ictu bipennis regium uideo caput;	i&ctu_ bi^pe_nni&s re_gi^u&m vi^de^o_ ca^pu&t 	X_^_X_^_^^_^X	1.0
Iam scelera prope sunt, iam dolus caedes cruor -	ja&m sce^le^ra^ pro^pe^ su&nt ja&m do^lu&s c[ae]de&s cru^o&r 	X^^^^^X_^_X_^X	1.0
Parantur epulae. causa natalis tui,	pa&ra_ntu^r e^pu^l[ae] c[au]sa^ na_ta&li&s tu^i& 	X_^^^X_^_X_^X	1.0
Aegisthe, uenit. quid pudor uultus grauat?	[ae]gi_sthe^ ve_ni&t qvi&d pu^do&r vu&ltu&s gra^va&t 	X_^_X_^_X_^X	0.43
Quid dextra dubio trepida consilio labat?	qvi&d de_xtra^ du^bi^o& tre^pi^da^ co_nsi^li^o_ la^ba&t 	X_^^^X^^^_^^_^X	1.0
Quid ipse temet consulis torques rogas,	qvi&d i_pse^ te_me&t co_nsu^li&s to&rqve&s ro^ga&s 	X_^_X_^_X_^X	1.0
An deceat hoc te? respice ad patrem: decet.	a&n de^ce^a^t ho&c te& re_spi^ce& a&d pa&tre&m de^ce&t 	X^^^_X_^_X_^X	1.0
Sed cur repente noctis aestiuae uices	se&d cu&r re^pe_nte& no_cti^s [ae]sti&vae_ vi^ce&s 	X_^_X_^_X_^X	1.0
Hiberna longa spatia producunt mora,	hi&be_rna^ lo_nga& spa^ti^a^ pro_du&cu&nt mo^ra& 	X_^_X^^^_X_^X	0.98
Aut quid cadentes detinet stellas polo?	[au]t qvi&d ca^de_nte&s de_ti^ne&t ste&lla&s po^lo& 	X_^_X_^_X_^X	1.0
Phoebum moramur. redde iam mundo diem.	ph[oe]bu&m mo^ra_mu&r re_dde^ ja&m mu&ndo_ di^e&m 	X_^_X_^_X_^X	1.0
Quid, segnis anime, tuta consilia expetis?	qvi&d se_gni^s a^ni^me& tu_ta^ co_nsi^li^a& e_xpe^ti&s 	X_^^^X_^_^^_^X	1.0
Quid fluctuaris? clausa iam melior uia est.	qvi&d flu_ctu^a_ri&s cl[au]sa^ ja&m me^li^o&r vi^a& e&st 	X_^_X_^_^^_^X	1.0
Licuit pudicos coniugis quondam toros	li^cu^i&t pu^di_co&s co_nju^gi&s qvo&nda&m to^ro&s 	^^_^_X_^_X_^X	1.0
Et sceptra casta uidua tutari fide;	e&t sce_ptra^ ca_sta& vi^du^a^ tu_ta&ri_ fi^de&	X_^_X^^^_X_^X	m
Periere mores ius decus pietas fides	pe^ri^e_re^ mo_re&s ju&s de^cu&s pi^e^ta&s fi^de&s 	^^_^_X_^_^^_^X	1.0
Et qui redire cum perit nescit pudor;	e&t qvi_ re^di_re& cu&m pe^ri&t ne&sci&t pu^do&r 	X_^_X_^_X_^X	1.0
Da frena et omnem prona nequitiam incita:	da& fre_na& e^t o_mne&m pro_na^ ne_qvi^ti^a&m i_nci^ta&	X_^_X_^_^^_^X	m
Per scelera semper sceleribus tutum est iter.	pe&r sce^le^ra^ se_mpe&r sce^le^ri^bu_s tu&tu&m e&st i^te&r 	X^^^_X^^^_X_^X	1.0
Tecum ipsa nunc euolue femineos dolos,	te&cu&m i_psa^ nu&nc [eu]o_lve^ fe_mi^ne^o&s do^lo&s 	X_^_X_^_^^_^X	1.0
Quod ulla coniunx perfida atque impos sui	qvo&d u_lla^ co_nju&nx pe_rfi^da& a_tqve& i&mpo_s su^i& 	X_^_X_^_X_^X	1.0
Amore caeco, quod nouercales manus	a&mo_re^ c[ae]co& qvo&d no^ve_rca&le&s ma^nu&s 	X_^_X_^_X_^X	1.0
Ausae, quod ardens impia uirgo face	[au]s[ae] qvo^d a_rde&ns i_mpi^a_ vi&rgo_ fa^ce& 	X_^_X_^_X_^X	0.53
Phasiaca fugiens regna Thessalica trabe:	pha&si^a^ca^ fu^gi^e&ns re_gna^ the_ssa^li^ca& tra^be&	X^^^^^X_^_^^_^X	m
Ferrum, uenena - uel Mycenaeas domos	fe&rru&m ve^ne_na& ve&l my^ce_n[ae]a&s do^mo&s 	X_^_X_^_X_^X	1.0
Coniuncta socio profuge furtiua rate.	co&nju_ncta^ so^ci^o& pro^fu^ge^ fu_rti&va_ ra^te& 	X_^^^X^^^_X_^X	1.0
Quid timida loqueris furta et exilium et fugas?	qvi&d ti^mi^da^ lo^qve^ri&s fu_rta& e^t e_xi^li^u&m e&t fu^ga&s 	X^^^^^X_^_^^_^X	1.0
Soror ista fecit: te decet maius nefas.	so^ro^r i_sta^ fe_ci&t te_ de^ce&t ma&ju&s ne^fa&s 	^^_^_X_^_X_^X	1.0
Regina Danaum et inclitum Ledae genus,	re&gi_na^ da^na^u&m e&t i_ncli^tu&m le&d[ae] ge^nu&s 	X_^^^X_^_X_^X	1.0
Quid tacita uersas quidue consilii impotens	qvi&d ta^ci^ta^ ve_rsa&s qvi_dve^ co_nsi^li^i& i_mpo^te&ns 	X^^^_X_^_^^_^X	1.0
Tumido feroces impetus animo geris?	tu^mi^do_ fe^ro_ce_s i_mpe^tu_s a^ni^mo_ ge^ri&s	^^_^_X_^_^^_^X	c
Licet ipsa sileas, totus in uultu est dolor.	li^ce^t i_psa^ si^le^a&s to_tu^s i&n vu&ltu& e&st do^lo&r 	^^_^^^X_^_X_^X	0.99
Proin quidquid est, da tempus ac spatium tibi:	pr[oi]n qvi_dqvi^d e&st da& te_mpu^s a&c spa^ti^u&m ti^bi& 	X_^_X_^_^^_^X	1.0
Quod ratio non quit, saepe sanauit mora.	qvo&d ra^ti^o^ no&n qvi&t s[ae]pe^ sa_na&vi_t mo^ra& 	X^^^_X_^_X_^X	0.98
Maiora cruciant quam ut moras possim pati;	ma&jo_ra^ cru^ci^a&nt qva&m u&t mo^ra&s po&ssi&m pa^ti& 	X_^^^X_^_X_^X	1.0
Flammae medullas et cor exurunt meum;	fla&mm[ae] me^du_lla&s e&t co^r e_xu&ru&nt me^u&m 	X_^_X_^_X_^X	1.0
Mixtus dolori subdidit stimulos timor;	mi&xtu&s do^lo_ri& su_bdi^di&t sti^mu^lo&s ti^mo&r 	X_^_X_^_^^_^X	1.0
Inuidia pulsat pectus, hinc animum iugo	i&nvi^di^a^ pu_lsa&t pe_ctu^s hi&nc a^ni^mu&m ju^go& 	X^^^_X_^_^^_^X	1.0
Premit cupido turpis et uinci uetat;	pre&mi&t cu^pi_do& tu_rpi^s e&t vi&nci_ ve^ta&t 	X_^_X_^_X_^X	0.95
Et inter istas mentis obsessae faces	e&t i_nte^r i_sta&s me_nti^s o_bse&ss[ae] fa^ce&s 	X_^_X_^_X_^X	0.98
Fessus quidem et deiectus et pessumdatus	fe&ssu&s qvi^de&m e&t d[ei]e_ctu^s e&t pe&ssu_mda^tu&s 	X_^_X_^_X_^X	1.0
Pudor rebellat. fluctibus uariis agor,	pu&do&r re^be_lla&t flu_cti^bu&s va^ri^i_s a^go&r	X_^_X_^_^^_^X	m
Vt, cum hinc profundum uentus, hinc aestus rapit,	u&t cu&m hi&nc pro^fu_ndu&m ve_ntu^s hi&nc [ae]stu&s ra^pi&t 	X_^_X_^_X_^X	1.0
Incerta dubitat unda cui cedat malo.	i&nce_rta^ du^bi^ta&t u_nda^ cu_j ce&da&t ma^lo& 	X_^^^X_^_X_^X	0.5
Proinde omisi regimen e manibus meis:	pro&i_nde& o^mi_si& re^gi^me^n e_ ma^ni^bu&s me^i&s: 	X_^_X^^^_^^_^X	m
Quocumque me ira, quo dolor, quo spes feret,	qvo&cu_mqve^ me& i_ra& qvo_ do^lo&r qvo& spe&s fe^re&t 	X_^_X_^_X_^X	1.0
Hoc ire pergam; fluctibus dedimus ratem.	ho&c i_re^ pe_rga&m flu_cti^bu&s de^di^mu&s ra^te&m 	X_^_X_^_^^_^X	1.0
Vbi animus errat, optimum est casum sequi.	u&bi& a^ni^mu^s e_rra&t o_pti^mu&m e&st ca&su&m se^qvi& 	X^^^_X_^_X_^X	1.0
Caeca est temeritas quae petit casum ducem.	c[ae]ca& e&st te^me^ri^ta&s qv[ae] pe^ti&t ca&su&m du^ce&m 	X_^^^X_^_X_^X	1.0
Cui ultima est fortuna, quid dubiam timet?	cu&i& u_lti^ma& e&st fo_rtu_na^, qui&d du^bi^a&m ti^me&t? 	X_^_X_^_^^_^X	m
Tuta est latetque culpa, si pateris, tua.	tu&ta& e&st la^te_tqve& cu_lpa^ si_ pa^te^ri&s tu^a& 	X_^_X_^_^^_^X	1.0
Perlucet omne regiae uitium domus.	pe&rlu_ce^t o_mne& re_gi^[ae] vi^ti^u&m do^mu&s 	X_^_X_^_^^_^X	1.0
Piget prioris et nouum crimen struis?	pi&ge&t pri^o_ri&s e&t no^vu&m cri&me&n stru^i&s 	X_^_X_^_X_^X	1.0
Res est profecto stulta nequitiae modus.	re&s e&st pro^fe_cto& stu_lta^ ne_qvi^ti^[ae] mo^du&s	X_^_X_^_^^_^X	m
Quod metuit auget qui scelus scelere obruit.	qvo&d me^tu^i^t [au]ge&t qvi& sce^lu&s sce^le^re& o_bru^i&t 	X^^^_X_^_^^_^X	1.0
Et ferrum et ignis saepe medicinae loco est.	e&t fe_rru&m e^t i_gni&s s[ae]pe^ me^di^ci&n[ae] lo^co& e&st 	X_^_X_^^^X_^X	1.0
Extrema primo nemo temptauit loco.	e&xtre_ma^ pri_mo& ne_mo^ te_mpt[au]i&t lo^co& 	X_^_X_^_X_^X	0.5
Rapienda rebus in malis praeceps uia est.	ra^pi^e_nda^ re_bu&s i&n ma^li&s pr[ae]ce&ps vi^a& e&st 	^^_^_X_^_X_^X	0.92
At te reflectat coniugi nomen sacrum.	a&t te_ re^fle_cta&t co_nju^gi_ no&me&n sa^cru&m 	X_^_X_^_X_^X	0.32
Decem per annos uidua respiciam uirum?	de&ce&m pe^r a_nno&s vi^du^a^ re_spi^ci^a&m vi^ru&m 	X_^_X^^^_^^_^X	1.0
Meminisse debes sobolis ex illo tuae.	me^mi^ni_sse^ de_be&s so^bo^li^s e&x i&llo_ tu^[ae] 	^^_^_X^^^_X_^X	1.0
Equidem et iugales filiae memini faces	e^qvi^de&m e&t ju^ga_le&s fi_li^[ae] me^mi^ni_ fa^ce&s 	^^_^_X_^_^^_^X	0.98
Et generum Achillem: praestitit matri fidem.	e&t ge^ne^ru&m a^chi_lle&m pr[ae]sti^ti&t ma&tri_ fi^de&m 	X^^^_X_^_X_^X	1.0
Redemit illa classis immotae moras	re&de_mi^t i_lla& cla_ssi^s i_mmo&tae_ mo^ra&s 	X_^_X_^_X_^X	0.75
Et maria pigro fixa languore impulit.	e&t ma^ri^a^ pi_gro& fi_xa^ la_ngvo&re& i_mpu^li&t 	X^^^_X_^_X_^X	1.0
Pudet doletque: Tyndaris, caeli genus,	pu&de&t do^le_tqve& ty_nda^ri&s c[ae]li_ ge^nu&s 	X_^_X_^_X_^X	1.0
Lustrale classi Doricae peperi caput!	lu&stra_le^ cla_ssi& do_ri^c[ae] pe^pe^ri_ ca^pu&t 	X_^_X_^_^^_^X	1.0
Reuoluit animus uirginis thalamos meae	re&vo_lvi^t a^ni^mu&s vi_rgi^ni&s tha^la^mo&s me^[ae] 	X_^^^X_^_^^_^X	1.0
Quos ille dignos Pelopia fecit domo,	qvo&s i_lle^ di_gno&s pe^lo^pi^a_ fe&ci&t do^mo&	X_^_X^^^_X_^X	m
Cum stetit ad aras ore sacrifico pater	cu&m ste^ti^t a^d a_ra&s o_re^ sa_cri^fi^co_ pa^te&r 	X^^^_X_^_^^_^X	1.0
Quam nuptialis! horruit Calchas suae	qva&m nu_pti^a_li&s ho_rru^i&t ca&lcha&s su^[ae] 	X_^_X_^_X_^X	1.0
Responsa uocis et recedentes focos.	re&spo_nsa^ vo_ci&s e&t re^ce_de&nte_s fo^co&s 	X_^_X_^_X_^X	1.0
O scelera semper sceleribus uincens domus:	o& sce^le^ra^ se_mpe&r sce^le^ri^bu&s vi&nce&ns do^mu&s	X^^^_X^^^_X_^X	m
Cruore uentos emimus, bellum nece!	cru&o_re^ ve_nto&s e_mi^mu&s be&llu&m ne^ce& 	X_^_X_^_X_^X	0.33
Sed uela pariter mille fecerunt rates?	se&d ve_la^ pa^ri^te&r mi_lle^ fe_ce&ru&nt ra^te&s 	X_^^^X_^_X_^X	1.0
Non est soluta prospero classis deo;	no&n e&st so^lu_ta& pro_spe^ro_ cla&ssi&s de^o& 	X_^_X_^_X_^X	1.0
Eiecit Aulis impias portu rates.	[ei]e_ci^t [au]li&s i_mpi^a&s po&rtu_ ra^te&s 	X_^_X_^_X_^X	1.0
Sic auspicatus bella non melius gerit:	si&c [au]spi^ca_tu&s be_lla^ no&n me^li^u&s ge^ri&t 	X_^_X_^_^^_^X	1.0
Amore captae captus, immotus prece	a&mo_re^ ca_pt[ae] ca_ptu^s i_mmo&tu&s pre^ce& 	X_^_X_^_X_^X	1.0
Zminthea tenuit spolia Phoebei senis,	zmi&nthe_a^ te^nu^i&t spo^li^a^ ph[oe]be&i_ se^ni&s 	X_^^^X^^^_X_^X	0.83
Ardore sacrae uirginis iam tum furens.	a&rdo_re^ sa_cr[ae] vi_rgi^ni&s ja&m tu&m fu^re&ns 	X_^_X_^_X_^X	0.93
Non illum Achilles flexit indomitus minis,	no&n i_llu&m a^chi_lle&s fle_xi^t i_ndo^mi^tu&s mi^ni&s 	X_^_X_^_^^_^X	1.0
Non ille solus fata qui mundi uidet	no&n i_lle^ so_lu&s fa_ta^ qvi_ mu&ndi_ vi^de&t 	X_^_X_^_X_^X	1.0
(In nos fidelis augur, in captas leuis),	i&n no&s fi^de_li&s [au]gu^r i&n ca&pta&s le^vi&s 	X_^_X_^_X_^X	0.9
Non populus aeger et relucentes rogi;	no&n po^pu^lu^s [ae]ge&r e&t re^lu_ce&nte_s ro^gi& 	X^^^_X_^_X_^X	0.84
Inter ruentis Graeciae stragem ultimam	i&nte&r ru^e_nti&s gr[ae]ci^[ae] stra&ge&m u_lti^ma&m 	X_^_X_^_X_^X	1.0
Sine hoste uictus marcet ac Veneri uacat	si&ne& ho_ste^ vi_ctu&s ma_rce^t a&c ve^ne^ri_ va^ca&t 	X_^_X_^_^^_^X	1.0
Reparatque amores; neue desertus foret	re^pa^ra_tqve& a^mo_re&s n[eu]e^ de_se&rtu&s fo^re&t 	^^_^_X_^_X_^X	1.0
A paelice umquam barbara caelebs torus,	a& p[ae]li^ce& u_mqva&m ba_rba^ra_ c[ae]le&bs to^ru&s 	X_^_X_^_X_^X	1.0
Ablatam Achilli diligit Lyrnesida	a&bla_ta&m a^chi_lli& di_li^gi&t ly&rne_si^da& 	X_^_X_^_X_^X	1.0
Nec rapere puduit e sinu auulsam uiri -	ne&c ra^pe^re^ pu^du^i&t e_ si^nu& [au]u&lsa&m vi^ri& 	X^^^^^X_^_X_^X	1.0
En Paridis hostem! nunc nouum uulnus gerens	e&n pa^ri^di^s ho_ste&m nu&nc no^vu&m vu&lnu&s ge^re&ns 	X^^^_X_^_X_^X	1.0
Amore Phrygiae uatis incensus furit,	a&mo_re^ phry^gi^[ae] va_ti^s i_nce&nsu&s fu^ri&t 	X_^^^X_^_X_^X	1.0
Et post tropaea Troica ac uersum Ilium	e&t po&st tro^p[ae]a& tro_i^ca& a&c ve&rsu&m i_li^u&m 	X_^_X_^_X_^X	1.0
Captae maritus remeat et Priami gener.	ca&pt[ae] ma^ri_tu&s re^me^a^t e&t pri^a^mi_ ge^ne&r 	X_^_X^^^_^^_^X	1.0
Accingere, anime: bella non leuia apparas.	a&cci_nge^re& a^ni^me& be_lla^ no&n le^vi^a& a_ppa^ra&s 	X_^^^X_^_^^_^X	0.5
Scelus occupandum est; pigra, quem expectas diem?	sce^lu^s o_ccu^pa_ndu&m e&st pi_gra^ qve&m e_xpe&cta&s di^e&m 	^^_^_X_^_X_^X	1.0
Pelopia Phrygiae sceptra dum teneant nurus?	pe&lo^pi^a^ phry^gi^[ae] sce_ptra^ du&m te^ne^a&nt nu^ru&s	X^^^^^X_^_^^_^X	m
An te morantur uirgines uiduae domi	a&n te_ mo^ra_ntu&r vi_rgi^ne&s vi^du^[ae] do^mi&	X_^_X_^_^^_^X	m
Patrique Orestes similis? horum te mala	pa&tri_qve& o^re_ste&s si^mi^li^s ho_ru&m te_ ma^la& 	X_^_X^^^_X_^X	0.93
Ventura moueant, turbo quis rerum imminet.	ve&ntu_ra^ mo^ve^a&nt tu_rbo^ qvi&s re&ru&m i_mmi^ne&t 	X_^^^X_^_X_^X	1.0
Quid, misera, cessas? en adest gnatis tuis	qvi&d mi^se^ra^ ce_ssa&s e_n a^de&st gna&ti&s tu^i&s 	X^^^_X_^_X_^X	1.0
Furens nouerca per tuum, si aliter nequit,	fu&re&ns no^ve_rca& pe&r tu^u&m si& a^li^te&r ne^qvi&t 	X_^_X_^_^^_^X	1.0
Latus exigatur ensis et perimat duos;	la^tu^s e_xi^ga_tu&r e_nsi^s e&t pe^ri^ma&t du^o&s 	^^_^_X_^_^^_^X	0.93
Misce cruorem, perde pereundo uirum:	mi&sce& cru^o_re&m pe_rde^ pe^re^u&ndo_ vi^ru&m 	X_^_X_^^^X_^X	1.0
Mors misera non est commori cum quo uelis.	mo&rs mi^se^ra^ no_n e&st co_mmo^ri_ cu&m qvo_ ve^li&s 	X^^^_X_^_X_^X	0.45
Regina, frena temet et siste impetus	re&gi_na^ fre_na& te_me^t e&t si&ste& i_mpe^tu&s 	X_^_X_^_X_^X	1.0
Et quanta temptes cogita: uictor uenit	e&t qva_nta^ te_mpte&s co_gi^ta_ vi&cto&r ve^ni&t 	X_^_X_^_X_^X	0.57
Asiae ferocis, ultor Europae, trahit	a^si^[ae] fe^ro_ci&s u_lto^r [eu]ro&p[ae] tra^hi&t 	^^_^_X_^_X_^X	1.0
Captiua Pergama et diu uictos Phrygas;	ca&pti_va^ pe_rga&ma& e&t di^u_ vi&cto&s phry^ga&s 	X_^_X_^_X_^X	1.0
Hunc fraude nunc conaris et furto aggredi?	hu&nc fr[au]de^ nu&nc co&na_ri^s e&t fu&rto& a_ggre^di& 	X_^_X_^_X_^X	1.0
Quem non Achilles ense uiolauit fero,	qve&m no_n a^chi_lle&s e_nse^ vi^o^l[au]i&t fe^ro& 	X_^_X_^^^X_^X	1.0
Quamuis procacem toruus armasset manum,	qva&mvi&s pro^ca_ce&m to_rvu^s a_rma&sse&t ma^nu&m 	X_^_X_^_X_^X	1.0
Non melior Aiax morte decreta furens,	no&n me^li^o^r a_ja&x mo_rte^ de_cre&ta_ fu^re&ns 	X^^^_X_^_X_^X	1.0
Non sola Danais Hector et bello mora,	no&n so_la^ da^na^i&s he_cto^r e&t be&llo_ mo^ra& 	X_^^^X_^_X_^X	0.95
Non tela Paridis certa, non Memnon niger,	no&n te_la^ pa^ri^di&s ce_rta^ no&n me&mno_n ni^ge&r 	X_^^^X_^_X_^X	1.0
Non Xanthus armis corpora immixta aggerens	no&n xa_nthu^s a_rmi&s co_rpo^ra& i_mmi&xta& a_gge^re&ns 	X_^_X_^_X_^X	1.0
Fluctusque Simois caede purpureos agens,	flu&ctu_sqve^ si^mo^i&s c[ae]de^ pu_rpu^re^o_s a^ge&ns 	X_^^^X_^_^^_^X	1.0
Non niuea proles Cycnus aequorei dei,	no&n ni^ve^a^ pro_le&s cy_cnu^s [ae]qvo^re^i_ de^i& 	X^^^_X_^_^^_^X	1.0
Non bellicoso Thressa cum Rheso phalanx,	no&n be_lli^co_so& thre_ssa^ cu&m rhe&so_ pha^la&nx 	X_^_X_^_X_^X	1.0
Non picta pharetras et securigera manu	no&n pi_cta^ pha^re^tra&s e&t se^cu_ri^ge^ra_ ma^nu&	X_^^^X_^_^^_^X	m
Peltata Amazon, hunc domi reducem paras	pe&lta_ta& a^ma_zo&n hu&nc do^mi_ re^du^ce&m pa^ra&s 	X_^_X_^_^^_^X	1.0
Mactare et aras caede maculare impia?	ma&cta_re& e^t a_ra&s c[ae]de^ ma^cu^la&re& i_mpi^a& 	X_^_X_^^^X_^X	1.0
Vltrix inultum Graecia hoc facinus feret?	u&ltri&x i^nu_ltu&m gr[ae]ci^a& ho&c fa^ci^nu&s fe^re&t 	X_^_X_^_^^_^X	1.0
Equos et arma classibusque horrens fretum	e&qvo_s e^t a_rma& cla_ssi^bu_sqve& ho&rre&ns fre^tu&m 	X_^_X_^_X_^X	0.96
Propone et alto sanguine exundans solum	pro&po_ne& e^t a_lto& sa_ngvi^ne& e_xu&nda&ns so^lu&m 	X_^_X_^_X_^X	0.37
Et tota captae fata Dardaniae domus	e&t to_ta^ ca_pt[ae] fa_ta^ da_rda^ni^[ae] do^mu&s 	X_^_X_^_^^_^X	1.0
Regesta Danais - comprime adfectus truces	re&ge_sta^ da^na^i&s co_mpri^me& a_dfe&ctu&s tru^ce&s 	X_^^^X_^_X_^X	1.0
Mentemque tibimet ipsa pacifica tuam.	me&nte_mqve^ ti^bi^me&t i_psa^ pa_ci&fi^ca^ tu^a&m	X_^^^X_^_X^^^X	m
Quod tempus animo semper ac mente horrui	quo&d te_mpu^s a^ni^mo_ se_mpe^r a&c me_nte& ho_rru^i& 	X_^^^X_^_X_^X	m
Adest profecto, rebus extremum meis.	a&de&st pro^fe_cto& re_bu^s e_xtre&mu&m me^i&s 	X_^_X_^_X_^X	1.0
Quid terga uertis, anime? quid primo impetu	qvi&d te_rga^ ve_rti&s a^ni^me^ qvi&d pri&mo& i_mpe^tu& 	X_^_X^^^_X_^X	1.0
Deponis arma? crede perniciem tibi	de&po_ni^s a_rma& cre_de^ pe_rni^ci^e&m ti^bi& 	X_^_X_^_^^_^X	1.0
Et dira saeuos fata moliri deos:	e&t di_ra^ s[ae]vo&s fa_ta^ mo_li&ri_ de^o&s 	X_^_X_^_X_^X	1.0
Oppone cunctis uile suppliciis caput,	o&ppo_ne^ cu_ncti&s vi_le^ su_ppli^ci^i&s ca^pu&t 	X_^_X_^_^^_^X	1.0
Ferrumque et ignes pectore aduerso excipe,	fe&rru_mqve& e^t i_gne&s pe_cto^re& a_dve&rso& e_xci^pe& 	X_^_X_^_X_^X	1.0
Aegisthe: non est poena sic nato mori.	[ae]gi_sthe^ no_n e&st p[oe]na^ si&c na&to_ mo^ri& 	X_^_X_^_X_^X	1.0
Tu nos pericli socia, tu, Leda sata,	tu& no&s pe^ri_cli& so^ci^a^ tu_ le&da_ sa^ta& 	X_^_X^^^_X_^X	1.0
Comitare tantum: sanguinem reddet tibi	co^mi^ta_re^ ta_ntu&m sa_ngvi^ne&m re&dde&t ti^bi& 	^^_^_X_^_X_^X	1.0
Ignauus iste ductor ac fortis pater.	i&gn[au]u^s i_ste& du_cto^r a&c fo&rti&s pa^te&r 	X_^_X_^_X_^X	1.0
Sed quid trementis circuit pallor genas	se&d qvi&d tre^me_nti&s ci_rcu^i&t pa&llo&r ge^na&s 	X_^_X_^_X_^X	1.0
Iacensque uultu languido optutus stupet?	ja&ce_nsqve^ vu_ltu& la_ngvi^do& o_ptu&tu_s stu^pe&t 	X_^_X_^_X_^X	1.0
Amor iugalis uincit ac flectit retro,	a&mo&r ju^ga_li&s vi_nci^t a&c fle&cti&t re^tro& 	X_^_X_^_X_^X	0.35
Referimur illuc, unde non decuit prius	re&fe^ri^mu^r i_llu&c u_nde^ no&n de^cu^i&t pri^u&s	X^^^_X_^_^^_^X	m
Abire; sed nunc casta repetatur fides,	a&bi_re^ se&d nu&nc ca_sta^ re^pe^ta&tu&r fi^de&s 	X_^_X_^^^X_^X	1.0
Nam sera numquam est ad bonos mores uia:	na&m se_ra^ nu_mqva&m e&st a&d bo^no&s mo&re&s vi^a& 	X_^_X_^_X_^X	1.0
Quem paenitet peccasse paene est innocens.	qve&m p[ae]ni^te&t pe&cca_sse^ p[ae]ne& e&st i_nno^ce&ns 	X_^_X_^_X_^X	1.0
Quo raperis amens? credis aut speras tibi	qvo& ra^pe^ri^s a_me&ns cre_di^s [au]t spe&ra&s ti^bi& 	X^^^_X_^_X_^X	1.0
Agamemnonis fidele coniugium? ut nihil	a^ga^me_mno^ni&s fi&de_le^ co_nju^gi^u&m u&t ni^hi&l 	^^_^_X_^_^^_^X	1.0
Subesset animo quod graues faceret metus,	su&be_sse^t a^ni^mo& qvo&d gra^ve&s fa^ce^re&t me^tu&s 	X_^^^X_^_^^_^X	1.0
Tamen superba et impotens flatu nimis	ta&me&n su^pe_rba& e&t i_mpo^te_ns fla&tu_ ni^mi&s 	X_^_X_^_X_^X	1.0
Fortuna magno spiritus tumidos daret.	fo&rtu_na^ ma_gno& spi_ri^tu&s tu^mi^do&s da^re&t 	X_^_X_^_^^_^X	1.0
Grauis ille sociis stante adhuc Troia fuit:	gra^ui^s i_lle^ so^ci^i&s sta_nte& a^dhu&c tro_ja_ fu^i&t: 	^^_^^^X_^_X_^X	m
Quid rere ad animum suapte natura trucem	qvi&d re_re& a^d a^ni^mu&m sva_pte^ na_tu&ra_ tru^ce&m 	X_^^^X_^_X_^X	1.0
Troiam addidisse? rex Mycenarum fuit,	tro&ja&m a_ddi^di_sse& re&x my^ce_na&ru_m fu^i&t 	X_^_X_^_X_^X	1.0
Veniet tyrannus: prospera animos efferunt.	ve^ni^e&t ty^ra_nnu&s pro_spe^ra& a^ni^mo&s e_ffe^ru&nt 	^^_^_X_^^^X_^X	1.0
Effusa circa paelicum quanto uenit	e&ffu_sa^ ci_rca& p[ae]li^cu_m qva&nto_ ve^ni&t 	X_^_X_^_X_^X	0.57
Turba apparatu! sola sed turba eminet	tu&rba& a_ppa^ra_tu& so_la^ se&d tu&rba& e_mi^ne&t 	X_^_X_^_X_^X	0.97
Tenetque regem famula ueridici dei.	te&ne_tqve^ re_ge&m fa^mu^la^ ve_ri^di^ci_ de^i&	X_^_X^^^_^^_^X	m
Feresne thalami uicta consortem tui?	fe&re_sne^ tha^la^mi& vi_cta^ co_nso&rte&m tu^i& 	X_^^^X_^_X_^X	1.0
At illa nolet. ultimum est nuptae malum	a&t i_lla^ no_le&t u_lti^mu&m e&st nu&pt[ae] ma^lu&m 	X_^_X_^_X_^X	0.72
Palam maritam possidens paelex domum.	pa&la&m ma^ri_ta&m po_ssi^de_ns p[ae]le&x do^mu&m 	X_^_X_^_X_^X	1.0
Nec regna socium ferre nec taedae sciunt.	ne&c re_gna^ so^ci^u&m fe_rre^ ne&c t[ae]d[ae] sci^u&nt 	X_^^^X_^_X_^X	1.0
Aegisthe, quid me rursus in praeceps agis	[ae]gi_sthe^ qvi&d me& ru_rsu^s i&n pr[ae]ce&ps a^gi&s 	X_^_X_^_X_^X	0.8
Iramque flammis iam residentem incitas?	i&ra_mque^ fla_mmi&s ia&m re^si_de_nte&m i_nci^ta&s? 	X_^_X_^_X_^X	m
Permisit aliquid uictor in captam sibi:	pe&rmi_si^t a^li^qvi&d vi_cto^r i&n ca&pta&m si^bi& 	X_^^^X_^_X_^X	1.0
Nec coniugem hoc respicere nec dominam decet.	ne&c co_nju^ge&m ho&c re&spi^ce^re^ ne&c do^mi^na&m de^ce&t 	X_^_X^^^_^^_^X	1.0
Lex alia solio est, alia priuato in toro.	le&x a^li^a^ so^li^o& e&st a^li^a^ pri_va&to& i&n to^ro& 	X^^^^^X^^^_X_^X	1.0
Quid, quod seueras ferre me leges uiro	qvi&d qvo&d se^ve_ra&s fe_rre^ me_ le&ge&s vi^ro& 	X_^_X_^_X_^X	1.0
Non patitur animus turpis admissi memor?	no&n pa^ti^tu^r a^ni^mu&s tu_rpi^s a_dmi&ssi_ me^mo&r 	X^^^^^X_^_X_^X	1.0
Det ille ueniam facile cui uenia est opus.	de&t i_lle^ ve^ni^a&m fa^ci^le^ cu_j ve^ni^a& e&st o^pu&s 	X_^^^X^^^_^^_^X	1.0
Ita est? pacisci mutuam ueniam licet?	i&ta& e&st pa^ci_sci& mu_tu^a_m ve^ni^a&m li^ce&t 	X_^_X_^_^^_^X	1.0
Ignota tibi sunt iura regnorum aut noua?	i&gno_ta^ ti^bi^ su&nt ju_ra^ re_gno&ru&m [au]t no^va& 	X_^^^X_^_X_^X	0.85
Nobis maligni iudices, aequi sibi,	no&bi&s ma^li_gni& ju_di^ce_s [ae]qvi_ si^bi& 	X_^_X_^_X_^X	1.0
Id esse regni maximum pignus putant,	i&d e_sse^ re_gni& ma_xi^mu&m pi&gnu&s pu^ta&nt 	X_^_X_^_X_^X	1.0
Si quidquid aliis non licet solis licet.	si& qvi_dqvi^d a^li^i&s no&n li^ce&t so&li&s li^ce&t 	X_^^^X_^_X_^X	1.0
Ignouit Helenae: iuncta Menelao redit	i&gno_vi^t he^le^n[ae] ju_ncta^ me^ne^la&o_ re^di&t	X_^^^X_^^^X_^X	m
Quae Europam et Asiam paribus afflixit malis.	qv[ae] [eu]ro_pa&m e^t a^si^a&m pa^ri^bu^s a_ffli&xi&t ma^li&s 	X_^^^X^^^_X_^X	0.92
Sed nulla Atriden Venere furtiua abstulit	se&d nu_lla& a^tri_de&n ve^ne^re^ fu_rti&va& a_bstu^li&t 	X_^_X^^^_X_^X	0.06
Nec cepit animum coniugi obstrictum suae.	ne&c ce_pi^t a^ni^mu&m co_nju^gi& o_bstri&ctu&m su^[ae] 	X_^^^X_^_X_^X	1.0
Iam crimen ille quaerit et causas parat.	ja&m cri_me^n i_lle& qv[ae]ri^t e&t c[au]sa&s pa^ra&t 	X_^_X_^_X_^X	1.0
Nil esse crede turpe commissum tibi:	ni&l e_sse^ cre_de& tu_rpe^ co_mmi&ssu&m ti^bi& 	X_^_X_^_X_^X	1.0
Quid honesta prodest uita, flagitio uacans?	qvi^d ho^ne_sta^ pro_de&st vi_ta^ fla_gi^ti^o_ va^ca&ns	^^_^_X_^_^^_^X	m
Vbi dominus odit, fit nocens, non quaeritur.	u^bi^ do^mi^nu^s o_di&t fi&t no^ce&ns no&n qv[ae]ri^tu&r 	^^^^^_X_^_X_^X	1.0
Spartenne repetes spreta et Eurotan tuum	spa&rte_nne^ re^pe^te&s spre_ta& e^t [eu]ro&ta&n tu^u&m 	X_^^^X_^_X_^X	1.0
Patriasque sedes profuga? non dant exitum	pa^tri^a_sqve^ se_de&s pro^fu^ga^ no&n da&nt e_xi^tu&m 	^^_^_X^^^_X_^X	0.98
Repudia regum: spe metus falsa leuas.	re&pu^di^a^ re_gu&m spe_ me^tu&s fa&lsa_ le^va&s	X^^^_X_^_X_^X	m
Delicta nouit nemo nisi fidus mea.	de&li_cta^ no_vi&t ne_mo^ ni^si^ fi&du&s me^a& 	X_^_X_^^^X_^X	0.49
Non intrat umquam regium limen fides.	no&n i_ntra^t u_mqva&m re_gi^u&m li&me&n fi^de&s 	X_^_X_^_X_^X	1.0
Opibus merebor, ut fidem pretio obligem.	o^pi^bu&s me^re_bo&r u&t fi^de&m pre^ti^o& o_bli^ge&m 	^^_^_X_^_^^_^X	1.0
Pretio parata uincitur pretio fides.	pre^ti^o_ pa^ra_ta& vi_nci^tu&r pre^ti^o_ fi^de&s 	^^_^_X_^_^^_^X	1.0
Surgit residuus pristinae mentis pudor;	su&rgi&t re^si^du^u&s pri_sti^nae_ me&nti&s pu^do&r	X_^^^X_^_X_^X	m
Quid obstrepis? quid uoce blandiloqua mala	qvi&d o_bstre^pi&s qvi&d vo_ce^ bla_ndi^lo^qva_ ma^la&	X_^_X_^_^^_^X	m
Consilia dictas? scilicet nubam tibi,	co&nsi^li^a^ di_cta&s sci_li^ce&t nu&ba&m ti^bi& 	X^^^_X_^_X_^X	1.0
Regum relicto rege, generosa exuli?	re&gu&m re^li_cto& re_ge^ ge^ne^ro&sa& e_xu^li& 	X_^_X_^^^X_^X	0.93
Et cur Atrida uideor inferior tibi,	e&t cu_r a^tri_da& vi^de^o^r i_nfe^ri^o&r ti^bi& 	X_^_X^^^_^^_^X	1.0
Gnatus Thyestae? Si parum est, adde et nepos.	gna&tu_s thy^e_st[ae] si_ pa^ru&m e&st a&dde& e&t ne^po&s 	X_^_X_^_X_^X	1.0
Auctore Phoebo gignor; haud generis pudet.	[au]cto_re^ ph[oe]bo& gi_gno^r h[au]d ge^ne^ri&s pu^de&t 	X_^_X_^_^^_^X	1.0
Phoebum nefandae stirpis auctorem uocas,	ph[oe]bu&m ne^fa_nd[ae] sti_rpi^s [au]cto&re&m vo^ca&s 	X_^_X_^_X_^X	1.0
Quem nocte subita frena reuocantem sua	qve&m no_cte^ su^bi^ta& fre_na^ re^vo^ca&nte&m su^a& 	X_^^^X_^^^X_^X	1.0
Caelo expulistis? quid deos probro addimus?	c[ae]lo& e_xpu^li_sti&s qvi&d de^o&s pro&bro& a_ddi^mu&s 	X_^_X_^_X_^X	1.0
Subripere doctus fraude geniales toros,	su&bri^pe^re^ do_ctu&s fr[au]de^ ge^ni^a&le&s to^ro&s	X^^^_X_^^^X_^X	m
Quem Venere tantum scimus inlicita uirum,	qve&m ve^ne^re^ ta_ntu&m sci_mu^s i_nli^ci^ta_ vi^ru&m	X^^^_X_^_^^_^X	m
Facesse propere ac dedecus nostrae domus	fa&ce_sse^ pro^pe^re& a&c de_de^cu&s no&str[ae] do^mu&s 	X_^^^X_^_X_^X	1.0
Asporta ab oculis: haec uacat regi ac uiro.	a&spo_rta& a^b o^cu^li&s h[ae]c va^ca&t re&gi& a&c vi^ro& 	X_^^^X_^_X_^X	1.0
Exilia mihi sunt haud noua; assueui malis.	e&xi^li^a^ mi^hi^ su&nt h[au]d no^va& a_ssve&vi_ ma^li&s 	X^^^^^X_^_X_^X	0.75
Si tu imperas, regina, non tantum domo	si& tu& i_mpe^ra&s re&gi_na^ no&n ta&ntu&m do^mo& 	X_^_X_^_X_^X	1.0
Argisue cedo: nil moror iussu tuo	a&rgi_sve^ ce_do& ni&l mo^ro&r ju&ssu_ tu^o& 	X_^_X_^_X_^X	1.0
Aperire ferro pectus aerumnis graue.	a^pe^ri_re^ fe_rro& pe_ctu^s [ae]ru&mni_s gra^ve& 	^^_^_X_^_X_^X	1.0
Siquidem hoc cruenta Tyndaris fieri sinam.	si^qvi^de&m ho&c cru^e_nta& ty_nda^ri&s fi^e^ri_ si^na&m 	^^_^_X_^_^^_^X	1.0
Quae iuncta peccat debet et culpae fidem.	qv[ae] ju_ncta^ pe_cca&t de_be^t e&t cu&lp[ae] fi^de&m 	X_^_X_^_X_^X	1.0
Secede mecum potius, ut rerum statum	se&ce_de^ me_cu&m po^ti^u^s u&t re&ru&m sta^tu&m 	X_^_X^^^_X_^X	1.0
Dubium ac minacem iuncta consilia explicent.	du^bi^u&m a&c mi^na_ce&m ju_ncta^ co_nsi^li^a& e_xpli^ce&nt 	^^_^_X_^_^^_^X	1.0
Sed ecce, uasto concitus miles gradu	se&d e_cce^ va_sto& co_nci^tu&s mi&le&s gra^du& 	X_^_X_^_X_^X	1.0
Manifesta properat signa laetitiae ferens	ma^ni^fe_sta^ pro^pe^ra&t si_gna^ l[ae]ti^ti^[ae] fe^re&ns 	^^_^^^X_^_^^_^X	1.0
(Namque hasta summo lauream ferro gerit)	na&mqve& ha_sta^ su_mmo& l[au]re^a_m fe&rro_ ge^ri&t 	X_^_X_^_X_^X	1.0
Fidusque regi semper Eurybates adest.	fi&du_sqve^ re_gi& se_mpe^r [eu]ry^ba^te_s a^de&st	X_^_X_^_^^_^X	m
Delubra et aras caelitum et patrios lares	de&lu_bra& e^t a_ra&s c[ae]li^tu&m e&t pa^tri^o&s la^re&s 	X_^_X_^_^^_^X	1.0
Post longa fessus spatia, uix credens mihi,	po&st lo_nga^ fe_ssu&s spa^ti^a^ vi&x cre&de&ns mi^hi& 	X_^_X^^^_X_^X	1.0
Supplex adoro. uota superis soluite:	su&pple&x a^do_ro& vo_ta^ su^pe^ri&s so_lvi^te& 	X_^_X_^^^X_^X	1.0
Telluris altum remeat Argolicae decus	te&llu_ri^s a_ltu&m re^me^a^t a_rgo^li^c[ae] de^cu&s 	X_^_X^^^_^^_^X	1.0
Tandem ad penates uictor Agamemnon suos.	ta&nde&m a&d pe^na_te&s vi_cto^r a^ga^me&mno_n su^o&s 	X_^_X_^^^X_^X	1.0
Felix ad aures nuntius uenit meas.	fe&li&x a^d [au]re&s nu_nti^u&s ve&ni&t me^a&s 	X_^_X_^_X_^X	1.0
Vbinam petitus per decem coniunx mihi	u^bi^na&m pe^ti_tu&s pe&r de^ce&m co&nju&nx mi^hi& 	^^_^_X_^_X_^X	1.0
Annos moratur? pelagus an terras premit?	a&nno&s mo^ra_tu&r pe^la^gu^s a&n te&rra&s pre^mi&t 	X_^_X^^^_X_^X	1.0
Incolumis, auctus gloria, laude inclitus	i&nco^lu^mi^s [au]ctu&s glo_ri^a_ l[au]de& i_ncli^tu&s 	X^^^_X_^_X_^X	1.0
Reducem expetito litori impressit pedem.	re^du^ce&m e_xpe^ti_to& li_to^ri& i_mpre&ssi&t pe^de&m 	^^_^_X_^_X_^X	1.0
Sacris colamus prosperum tandem diem	sa&cri&s co^la_mu&s pro_spe^ru_m ta&nde&m di^e&m 	X_^_X_^_X_^X	1.0
Et si propitios attamen lentos deos.	e&t si& pro^pi^ti^o&s a_tta^me&n le&nto&s de^o&s	X_^^^X_^_X_^X	m
Tu pande uiuat coniugis frater mei	tu& pa_nde^ vi_va&t co_nju^gi&s fra&te&r me^i& 	X_^_X_^_X_^X	1.0
Et pande teneat quas soror sedes mea.	e&t pa_nde^ te^ne^a&t qva&s so^ro&r se&de&s me^a& 	X_^^^X_^_X_^X	1.0
Meliora uotis posco et obtestor deos:	me^li^o_ra^ vo_ti&s po_sco& e^t o_bte&sto&r de^o&s 	^^_^_X_^_X_^X	1.0
Nam certa fari sors maris dubii uetat.	na&m ce_rta^ fa_ri& so&rs ma^ri&s du^bi^i_ ve^ta&t 	X_^_X_^_^^_^X	1.0
Vt sparsa tumidum classis excepit mare,	u&t spa_rsa^ tu^mi^du&m cla_ssi^s e_xce&pi&t ma^re& 	X_^^^X_^_X_^X	0.75
Ratis uidere socia non potuit ratem.	ra&ti&s vi^de_re& so^ci^a^ no&n po^tu^i&t ra^te&m	X_^_X^^^_^^_^X	m
Quin ipse Atrides aequore immenso uagus	qvi&n i_pse& a^tri_de&s [ae]qvo^re& i_mme&nso_ va^gu&s 	X_^_X_^_X_^X	0.43
Grauiora pelago damna quam bello tulit	gra^vi^o_ra^ pe^la^go& da_mna^ qva&m be&llo_ tu^li&t 	^^_^^^X_^_X_^X	1.0
Remeatque uicto similis, exiguas trahens	re^me^a_tqve^ vi_cto& si^mi^li^s e_xi^gu^a&s tra^he&ns 	^^_^_X^^^_^^_^X	1.0
Lacerasque uictor classe de tanta rates.	la^ce^ra_sqve^ vi_cto&r cla_sse^ de_ ta&nta_ ra^te&s 	^^_^_X_^_X_^X	1.0
Quis fare nostras hauserit casus rates	qvi&s fa_re^ no_stra&s h[au]se^ri&t ca&su&s ra^te&s 	X_^_X_^_X_^X	1.0
Aut quae maris fortuna dispulerit duces.	[au]t qv[ae] ma^ri&s fo&rtu_na^ di_spu^le^ri&t du^ce&s 	X_^_X_^_^^_^X	1.0
Acerba fatu poscis, infaustum iubes	a&ce_rba^ fa_tu& po_sci^s i_nf[au]stu&m ju^be&s 	X_^_X_^_X_^X	1.0
Miscere laeto nuntium. refugit loqui	mi&sce_re^ l[ae]to& nu_nti^u&m re^fu^gi&t lo^qvi&	X_^_X_^_^^_^X	m
Mens aegra tantis atque inhorrescit malis.	me&ns [ae]gra^ ta_nti&s a_tqve& i^nho_rre&sci&t ma^li&s 	X_^_X_^_X_^X	0.92
Exprome: clades scire qui refugit suas	e&xpro_me^ cla_de&s sci_re^ qvi_ re^fu^gi&t su^a&s 	X_^_X_^_^^_^X	0.15
Grauat timorem; dubia plus torquent mala.	gra&va&t ti^mo_re&m du^bi^a^ plu&s to&rqve&nt ma^la& 	X_^_X^^^_X_^X	0.94
Vt Pergamum omne Dorica cecidit face,	u&t pe_rga^mu&m o_mne& do_ri^ca_ ce^ci^di&t fa^ce&	X_^_X_^_^^_^X	m
Diuisa praeda est, maria properantes petunt.	di&vi_sa^ pr[ae]da& e&st ma^ri^a^ pro^pe^ra&nte&s pe^tu&nt 	X_^_X^^^^^X_^X	1.0
Iamque ense fessum miles exonerat latus,	ja&mqve& e_nse^ fe_ssu&m mi_le^s e_xo^ne^ra&t la^tu&s	X_^_X_^_^^_^X	m
Neglecta summas scuta per puppes iacent;	ne&gle_cta^ su_mma&s scu_ta^ pe&r pu&ppe&s ja^ce&nt 	X_^_X_^_X_^X	1.0
Ad militares remus aptatur manus	a&d mi_li^ta_re&s re_mu^s a_pta&tu&r ma^nu&s 	X_^_X_^_X_^X	1.0
Omnisque nimium longa properanti mora est.	o&mni_sqve^ ni^mi^u&m lo_nga^ pro^pe^ra&nti_ mo^ra& e&st 	X_^^^X_^^^X_^X	0.98
Signum recursus regia ut fulsit rate	si&gnu&m re^cu_rsu&s re_gi^a& u&t fu&lsi&t ra^te& 	X_^_X_^_X_^X	1.0
Et clara laetum remigem monuit tuba,	e&t cla_ra^ l[ae]tu&m re_mi^ge_m mo^nu^i&t tu^ba& 	X_^_X_^_^^_^X	1.0
Aurata primas prora designat uias	[au]ra_ta^ pri_ma&s pro_ra^ de_si&gna&t vi^a&s 	X_^_X_^_X_^X	1.0
Aperitque cursus, mille quos puppes secent.	a^pe^ri_tqve^ cu_rsu&s mi_lle^ qvo&s pu&ppe&s se^ce&nt 	^^_^_X_^_X_^X	1.0
Hinc aura primo lenis impellit rates	hi&nc [au]ra^ pri_mo& le_ni^s i_mpe&lli&t ra^te&s 	X_^_X_^_X_^X	1.0
Adlapsa uelis; unda uix actu leui	a&dla_psa^ ve_li&s u_nda^ vi&x a&ctu_ le^vi& 	X_^_X_^_X_^X	0.53
Tranquilla Zephyri mollis afflatu tremit,	tra&nqui_lla^ ze^phy^ri& mo_lli^s a_ffla&tu& tre^mi&t, 	X_^^^X_^_X_^X	m
Splendetque classe pelagus et pariter latet.	sple&nde_tqve^ cla_sse& pe^la^gu^s e&t pa^ri^te&r la^te&t 	X_^_X^^^_^^_^X	1.0
Iuuat uidere nuda Troiae litora,	ju&va&t vi^de_re& nu_da^ tro_j[ae] li_to^ra& 	X_^_X_^_X_^X	0.34
Iuuat relicti sola Sigei loca.	ju&va&t re^li_cti& so_la^ si_ge&i_ lo^ca& 	X_^_X_^_X_^X	0.97
Properat iuuentus omnis adductos simul	pro^pe^ra&t ju^ve_ntu&s o_mni^s a_ddu&cto&s si^mu&l 	^^_^_X_^_X_^X	0.87
Lentare remos, adiuuat uentos manu	le&nta_re^ re_mo&s a_dju^va&t ve&nto&s ma^nu& 	X_^_X_^_X_^X	1.0
Et ualida nisu bracchia alterno mouet.	e&t va^li^da^ ni_su& bra_cchi^a& a_lte&rno_ mo^ve&t 	X^^^_X_^_X_^X	1.0
Sulcata uibrant aequora et latera increpant	su&lca_ta^ vi_bra&nt [ae]qvo^ra& e&t la^te^ra& i_ncre^pa&nt	X_^_X_^_^^_^X	m
Dirimuntque canae caerulum spumae mare.	di^ri^mu_ntqve^ ca_n[ae] c[ae]ru^lu&m spu&mae_ ma^re& 	^^_^_X_^_X_^X	1.0
Vt aura plenos fortior tendit sinus,	u&t [au]ra^ ple_no&s fo_rti^o&r te&ndi&t si^nu&s 	X_^_X_^_X_^X	1.0
Posuere tonsas, credita est uento ratis	po^su^e_re^ to_nsa&s cre_di^ta& e&st ve&nto_ ra^ti&s 	^^_^_X_^_X_^X	1.0
Fususque transtris miles aut terras procul,	fu&su_sqve^ tra_nstri&s mi_le^s [au]t te&rra&s pro^cu&l 	X_^_X_^_X_^X	1.0
Quantum recedunt uela, fugientes notat,	qva&ntu&m re^ce_du&nt ve_la^ fu^gi^e&nte&s no^ta&t 	X_^_X_^^^X_^X	1.0
Aut bella narrat: Hectoris fortis minas	[au]t be_lla^ na_rra&t he_cto^ri&s fo&rti&s mi^na&s 	X_^_X_^_X_^X	1.0
Currusque et empto redditum corpus rogo,	cu&rru_sqve& e^t e_mpto& re_ddi^tu&m co&rpu&s ro^go& 	X_^_X_^_X_^X	1.0
Sparsum cruore regis Herceum Iouem.	spa_rsu&m cru^o_re& re_gi^s he_rce&u_m io^ue&m. 	X_^_X_^_X_^X	m
Tunc qui iacente reciprocus ludit salo	tu&nc qvi_ ja^ce_nte^ re^ci_pro^cu&s lu&di&t sa^lo&	X_^_^^_^_X_^X	m
Tumidumque pando transilit dorso mare	tu^mi^du_mqve^ pa_ndo& tra_nsi^li&t do&rso_ ma^re& 	^^_^_X_^_X_^X	1.0
Tyrrhenus omni piscis exultat freto	ty&rrhe_nu^s o_mni& pi_sci^s e_xu&lta&t fre^to& 	X_^_X_^_X_^X	1.0
Agitatque gyros et comes lateri adnatat,	a^gi^ta_tqve^ gy_ro&s e&t co^me&s la^te^ri& a_dna^ta&t 	^^_^_X_^_^^_^X	1.0
Anteire naues laetus et rursus sequi;	a&nt[ei]re^ n[au]e&s l[ae]tu^s e&t ru&rsu&s se^qvi& 	X_^_X_^_X_^X	1.0
Nunc prima tangens rostra lasciuit chorus,	nu&nc pri_ma^ ta_nge&ns ro_stra^ la_sci&vi&t cho^ru&s 	X_^_X_^_X_^X	1.0
Millesimam nunc ambit et lustrat ratem.	mi&lle_si^ma&m nu&nc a_mbi^t e&t lu&stra&t ra^te&m 	X_^_X_^_X_^X	1.0
Iam litus omne tegitur et campi latent	ja&m li_tu^s o_mne& te^gi^tu^r e&t ca&mpi_ la^te&nt 	X_^_X^^^_X_^X	1.0
Et dubia pereunt montis Idaei iuga;	e&t du^bi^a^ pe^re^u&nt mo_nti^s i_d[ae]i_ ju^ga& 	X^^^^^X_^_X_^X	0.79
Et uix (quod unum peruicax acies uidet)	e&t vi&x qvo^d u_nu&m pe_rvi^ca_x a^ci^e&s vi^de&t 	X_^_X_^_^^_^X	1.0
Iliacus atra fumus apparet nota.	i&li^a^cu^s a_tra& fu_mu^s a_ppa&re&t no^ta& 	X^^^_X_^_X_^X	0.05
Iam lassa Titan colla releuabat iugo,	ja&m la_ssa^ ti_ta&n co_lla^ re^le^va&ba&t ju^go& 	X_^_X_^^^X_^X	1.0
In astra iam lux prona, iam praeceps dies:	i&n a_stra^ ja&m lu&x pro_na^ ja&m pr[ae]ce&ps di^e&s 	X_^_X_^_X_^X	1.0
Exigua nubes sordido crescens globo	e&xi^gu^a^ nu_be&s so_rdi^do& cre&sce&ns glo^bo& 	X^^^_X_^_X_^X	1.0
Nitidum cadentis inquinat Phoebi iubar;	ni^ti^du&m ca^de_nti&s i_nqvi^na&t ph[oe]bi_ ju^ba&r 	^^_^_X_^_X_^X	1.0
Suspecta uarius occidens fecit freta.	su&spe_cta^ va^ri^u&s o_cci^de_ns fe&ci&t fre^ta& 	X_^^^X_^_X_^X	0.94
Nox prima caelum sparserat stellis, iacent	no&x pri_ma^ c[ae]lu&m spa_rse^ra&t ste&lli&s ja^ce&nt 	X_^_X_^_X_^X	1.0
Deserta uento uela. tum murmur graue,	de&se_rta^ ve_nto& ve_la^ tu&m mu&rmu&r gra^ve& 	X_^_X_^_X_^X	1.0
Maiora minitans, collibus summis cadit	ma&jo_ra^ mi^ni^ta&ns co_lli^bu&s su&mmi&s ca^di&t 	X_^^^X_^_X_^X	1.0
Tractuque longo litus ac petrae gemunt;	tra&ctu_qve^ lo_ngo& li_tu^s a&c pe&trae_ ge^mu&nt 	X_^_X_^_X_^X	1.0
Agitata uentis unda uenturis tumet:	a^gi^ta_ta^ ve_nti&s u_nda^ ve_ntu&ri&s tu^me&t 	^^_^_X_^_X_^X	1.0
Cum subito luna conditur, stellae latent;	cu&m su^bi^to^ lu_na& co_ndi^tu&r, ste&ll[ae] la^te&nt; 	X^^^_X_^_X_^X	m
Nec una nox est: densa tenebras obruit	ne&c u_na^ no&x e&st de_nsa^ te^ne^bra&s o_bru^i&t 	X_^_X_^^^X_^X	0.57
Caligo et omni luce subducta fretum	ca&li_go& e^t o_mni& lu_ce^ su_bdu&cta_ fre^tu&m 	X_^_X_^_X_^X	0.96
Caelumque miscet. undique incumbunt simul	c[ae]lu_mqve^ mi_sce&t u_ndi^qve& i_ncu&mbu&nt si^mu&l 	X_^_X_^_X_^X	1.0
Rapiuntque pelagus infimo euersum solo	ra^pi^u_ntqve^ pe^la^gu&s i_nfi^mo& [eu]e&rsu&m so^lo& 	^^_^^^X_^_X_^X	0.71
Aduersus Euro Zephyrus et Boreae Notus.	a&dve_rsu^s [eu]ro& ze^phy^ru^s e&t bo^re^[ae] no^tu&s 	X_^_X^^^_^^_^X	0.55
Sua quisque mittunt tela et infesti fretum	su^a^ qvi_sqve^ mi_ttu&nt te_la& e^t i_nfe&sti& fre^tu&m 	^^_^_X_^_X_^X	0.96
Emoliuntur, turbo conuoluit mare:	e&mo_li^u_ntu&r tu_rbo^ co_nvo&lvi&t ma^re& 	X_^_X_^_X_^X	1.0
Strymonius altas Aquilo contorquet niues	stry&mo^ni^u^s a_lta&s a^qvi^lo^ co_nto&rqve&t ni^ve&s	X^^^_X^^^_X_^X	m
Libycusque harenas Auster ac Syrtes agit,	li^by^cu_sqve& ha^re_na&s [au]ste^r a&c sy&rte_s a^gi&t 	^^_^_X_^_X_^X	1.0
Nec manet in Austro; fit grauis nimbis Notus	ne&c ma^ne^t i^n [au]stro& fi&t gra^vi&s ni&mbi&s no^tu&s 	X^^^_X_^_X_^X	0.53
Imbre auget undas; Eurus orientem mouet	i&mbre& [au]ge^t u_nda&s [eu]ru^s o^ri^e&nte&m mo^ve&t 	X_^_X_^^^X_^X	1.0
Nabataea quatiens regna et Eoos sinus.	na^ba^t[ae]a^ qva^ti^e&ns re_gna& e^t e_o&o&s si^nu&s 	^^_^^^X_^_X_^X	1.0
Quid rabidus ora Corus Oceano exerens?	qvi&d ra^bi^du^s o_ra& co_ru^s o_ce^a^no& e_xe^re&ns 	X^^^_X_^_^^_^X	1.0
Mundum reuelli sedibus totum suis	mu&ndu&m re^ve_lli& se_di^bu&s to&tu&m su^i&s 	X_^_X_^_X_^X	1.0
Ipsosque rupto crederes caelo deos	i&pso_sqve^ ru_pto& cre_de^re&s c[ae]lo_ de^o&s 	X_^_X_^_X_^X	1.0
Decidere et atrum rebus induci chaos.	de&ci^de^re& e^t a_tru&m re_bu^s i_ndu&ci_ cha^o&s 	X^^^_X_^_X_^X	1.0
Vento resistit aestus et uentus retro	ve&nto_ re^si_sti&t [ae]stu^s e&t ve&ntu&s re^tro& 	X_^_X_^_X_^X	0.31
Aestum reuoluit; non capit sese mare:	[ae]stu&m re^vo_lvi&t no&n ca^pi&t se&se_ ma^re& 	X_^_X_^_X_^X	1.0
In astra pontus tollitur, caelum perit	i&n a_stra^ po_ntu&s to_lli^tu&r c[ae]lu&m pe^ri&t 	X_^_X_^_X_^X	1.0
Vndasque miscent imber et fluctus suas.	u&nda_sqve^ mi_sce&nt i_mbe^r e&t flu&ctu&s su^a&s 	X_^_X_^_X_^X	1.0
Nec hoc leuamen denique aerumnis datur,	ne&c ho&c le^va_me&n de_ni^qve& [ae]ru&mni_s da^tu&r 	X_^_X_^_X_^X	1.0
Videre saltem et nosse quo pereant malo:	vi&de_re^ sa_lte&m e&t no_sse^ qvo_ pe^re^a&nt ma^lo& 	X_^_X_^_^^_^X	0.5
Premunt tenebrae lumina et dirae Stygis	pre&mu&nt te^ne_br[ae] lu_mi^na& e&t di&r[ae] sty^gi&s 	X_^_X_^_X_^X	0.62
Inferna nox est. excidunt ignes tamen	i&nfe_rna^ no&x e&st. e_xci^du&nt i_gne&s ta^me&n 	X_^_X_^_X_^X	m
Et nube dirum fulmen elisa micat;	e&t nu_be^ di_ru&m fu_lme^n e_li&sa_ mi^ca&t 	X_^_X_^_X_^X	0.94
Miserisque lucis tanta dulcedo est malae:	mi^se^ri_sqve^ lu_ci&s ta_nta^ du_lce&do& e&st ma^l[ae] 	^^_^_X_^_X_^X	0.08
Hoc lumen optant. Ipsa se classis premit	ho&c lu_me^n o_pta&nt i_psa^ se& cla&ssi&s pre^mi&t 	X_^_X_^_X_^X	1.0
Et prora prorae nocuit et lateri latus.	e&t pro_ra^ pro_r[ae] no^cu^i^t e&t la^te^ri_ la^tu&s	X_^_X^^^_^^_^X	m
Illam dehiscens pontus in praeceps rapit	i&lla&m de^hi_sce&ns po_ntu^s i&n pr[ae]ce&ps ra^pi&t 	X_^_X_^_X_^X	1.0
Hauritque et alto redditam reuomit mari;	h[au]ri_tqve& e^t a_lto& re_ddi^ta&m re^vo^mi_t ma^ri& 	X_^_X_^_^^_^X	1.0
Haec onere sidit, illa conuulsum latus	h[ae]c o^ne^re^ si_di&t i_lla^ co_nvu&lsu&m la^tu&s 	X^^^_X_^_X_^X	0.98
Submittit undis, fluctus hanc decimus tegit;	su&bmi_tti^t u_ndi&s flu_ctu^s ha&nc de^ci^mu&s te^gi&t 	X_^_X_^_^^_^X	0.25
Haec lacera et omni decore populato leuis	h[ae]c la^ce^ra& e^t o_mni& de^co^re^ po^pu^la&to_ le^vi&s 	X^^^_X^^^^^X_^X	0.22
Fluitat nec illi uela nec tonsae manent	flu^i^ta&t ne^c i_lli& ve_la^ ne&c to&ns[ae] ma^ne&nt 	^^_^_X_^_X_^X	0.97
Nec rectus altas malus antemnas ferens,	ne&c re_ctu^s a_lta&s ma_lu^s a_nte&mna&s fe^re&ns 	X_^_X_^_X_^X	0.29
Sed trunca toto puppis Ionio natat.	se&d tru_nca^ to_to_ pu_ppi^s i_o_njo_ na^ta&t	X_^_X_^_X_^X	c
Nil ratio et usus audet: ars cessit malis;	ni&l ra^ti^o& e^t u_su&s [au]de^t a&rs ce&ssi&t ma^li&s 	X^^^_X_^_X_^X	0.92
Tenet horror artus, omnis officio stupet	te^ne^t ho_rro^r a_rtu&s o_mni^s o_ffi^ci^o& stu^pe&t 	^^_^_X_^_^^_^X	0.87
Nauita relicto, remus effugit manus.	n[au]i^ta^ re^li_cto& re_mu^s e_ffu&gi&t ma^nu&s 	X^^^_X_^_X_^X	1.0
In uota miseros ultimus cogit timor	i&n vo_ta^ mi^se^ro&s u_lti^mu&s co&gi&t ti^mo&r 	X_^^^X_^_X_^X	1.0
Eademque superos Troes et Danai rogant.	e^a^de_mqve^ su^pe^ro&s tro_e^s e&t da^na^i_ ro^ga&nt 	^^_^^^X_^_^^_^X	0.93
Quid fata possunt! inuidet Pyrrhus patri,	qvi&d fa_ta^ po_ssu&nt i_nvi^de&t py&rrhu&s pa^tri& 	X_^_X_^_X_^X	0.54
Aiaci Vlixes, Hectori Atrides minor,	a&ja_ci& u^li_xe&s he_cto^ri& a_tri&de&s mi^no&r 	X_^_X_^_X_^X	0.57
Agamemno Priamo: quisquis ad Troiam iacet	a^ga^me_mno^ pri^a^mo& qvi_sqvi^s a&d tro&ja&m ja^ce&t 	^^_^^^X_^_X_^X	1.0
Felix uocatur, cadere qui meruit gradu,	fe&li&x vo^ca_tu&r ca^de^re^ qvi_ me^ru^i&t gra^du& 	X_^_X^^^_^^_^X	1.0
Quem fama seruat, uicta quem tellus tegit.	qve&m fa_ma^ se_rva&t vi_cta^ qve&m te&llu&s te^gi&t 	X_^_X_^_X_^X	1.0
'Nil nobile ausos pontus atque undae ferent?	ni&l no_bi^le& [au]so&s po_ntu^s a_tqve& u&nd[ae] fe^re&nt 	X_^_X_^_X_^X	1.0
Ignaua fortes fata consument uiros?	i&gn[au]a^ fo_rte&s fa_ta^ co_nsu&me&nt vi^ro&s 	X_^_X_^_X_^X	1.0
Perdenda mors est? quisquis es, nondum malis	pe&rde_nda^ mo&rs e&st qvi_sqvi^s e&s no&ndu&m ma^li&s 	X_^_X_^_X_^X	0.92
Satiate tantis, caelitum, tandem tuum	sa^ti^a_te^ ta_nti&s c[ae]li^tu&m ta&nde&m tu^u&m	^^_^_X_^_X_^X	m
Numen serena: cladibus nostris daret	nu&me&n se^re_na& cla_di^bu&s no&stri&s da^re&t 	X_^_X_^_X_^X	1.0
Vel Troia lacrimas. odia si durant tua	ve&l tro_ja^ la^cri^ma&s o^di^a^ si_ du&ra&nt tu^a& 	X_^^^X^^^_X_^X	0.68
Placetque mitti Doricum exitio genus,	pla&ce_tqve^ mi_tti& do_ri^cu&m e_xi^ti^o_ ge^nu&s 	X_^_X_^_^^_^X	1.0
Quid hos simul perire nobiscum iuuat,	qvi&d ho&s si^mu&l pe&ri_re^ no_bi&scu&m ju^va&t 	X_^_X_^_X_^X	1.0
Quibus perimus? sistite infestum mare:	qvi&bu&s pe^ri_mu&s si_sti^te& i_nfe&stu&m ma^re& 	X_^_X_^_X_^X	1.0
Vehit ista Danaos classis? et Troas uehit!'	ve^hi^t i_sta^ da^na^o&s cla_ssi^s e&t tro&a&s ve^hi&t 	^^_^^^X_^_X_^X	0.75
Nec plura possunt: occupat uocem mare.	ne&c plu_ra^ po_ssu&nt o_ccu^pa&t vo&ce&m ma^re& 	X_^_X_^_X_^X	1.0
Ecce alia clades. fulmine irati Iouis	e&cce& a^li^a^ cla_de&s fu_lmi^ne& i_ra&ti_ jo^vi&s 	X^^^_X_^_X_^X	1.0
Armata Pallas quidquid aut hasta minax	a&rma_ta^ pa_lla&s qvi_dqvi^d [au]t ha&sta_ mi^na&x 	X_^_X_^_X_^X	1.0
Aut aegide et furore Gorgoneo potest,	[au]t [ae]gi^de& e&t fu&ro_re^ go_rgo^ne^o_ po^te&st 	X_^_X_^_^^_^X	0.92
Hoc igne patrio temptat, et caelo nouae	ho&c i_gne^ pa^tri^o& te_mpta^t e&t c[ae]lo_ no^v[ae] 	X_^^^X_^_X_^X	1.0
Spirant procellae. solus inuictus malis	spi&ra&nt pro^ce_ll[ae] so_lu^s i_nvi&ctu&s ma^li&s 	X_^_X_^_X_^X	0.92
Luctatur Aiax. uela cogentem hunc sua	lu&cta_tu^r a_ja&x ve_la^ co_ge&nte&m hu&nc su^a& 	X_^_X_^_X_^X	1.0
Tento rudente flamma perstrinxit cadens.	te&nto_ ru^de_nte& fla_mma^ pe_rstri&nxi&t ca^de&ns 	X_^_X_^_X_^X	1.0
Libratur aliud fulmen: hoc toto impetu	li&bra_tu^r a^li^u&d fu_lme^n ho&c to&to& i_mpe^tu& 	X_^^^X_^_X_^X	0.94
Certum reducta Pallas excussit manu,	ce&rtu&m re^du_cta& pa_lla^s e_xcu&ssi&t ma^nu& 	X_^_X_^_X_^X	0.82
Imitata patrem. transit Aiacem et ratem	i^mi^ta_ta^ pa_tre&m tra_nsi^t a_ja&ce&m e&t ra^te&m 	^^_^_X_^_X_^X	0.29
Ratisque partem secum et Aiacem tulit.	ra&ti_sqve^ pa_rte&m se_cu&m e^t a_ja&ce&m tu^li&t 	X_^_X_^_X_^X	1.0
Nil ille motus, ardua ut cautes, salo	ni&l i_lle^ mo_tu&s a_rdu^a& u&t c[au]te&s sa^lo& 	X_^_X_^_X_^X	1.0
Ambustus extat, dirimit insanum mare	a&mbu_stu^s e_xta&t di^ri^mi^t i_nsa&nu&m ma^re& 	X_^_X^^^_X_^X	1.0
Fluctusque rumpit pectore et nauem manu	flu&ctu_sqve^ ru_mpi&t pe_cto^re& e&t n[au]e&m ma^nu& 	X_^_X_^_X_^X	1.0
Complexus ignes traxit et caeco mari	co&mple_xu^s i_gne&s tra_xi^t e&t c[ae]co_ ma^ri& 	X_^_X_^_X_^X	0.86
Conlucet Aiax; omne resplendet fretum.	co&nlu_ce^t a_ja&x o_mne^ re_sple&nde&t fre^tu&m 	X_^_X_^_X_^X	0.96
Tandem occupata rupe furibundum intonat:	ta&nde&m o_ccu^pa_ta& ru_pe^ fu^ri^bu&ndu&m i_nto^na&t 	X_^_X_^^^X_^X	1.0
'Superasse saeuum pelagus atque ignes iuuat,	su^pe^ra_sse^ s[ae]vu&m pe^la^gu^s a_tqve& i&gne&s ju^va&t 	^^_^_X^^^_X_^X	1.0
Vicisse caelum Palladem fulmen mare.	vi&ci_sse^ c[ae]lu&m pa_lla^de_m fu&lme&n ma^re& 	X_^_X_^_X_^X	1.0
Non me fugauit bellici terror dei,	no&n me_ fu^g[au]i&t be_lli^ci_ te&rro&r de^i& 	X_^_X_^_X_^X	1.0
Et Hectorem una solus et Martem tuli	e&t he_cto^re&m u_na& so_lu^s e&t ma&rte&m tu^li& 	X_^_X_^_X_^X	1.0
Phoebea nec me tela pepulerunt gradu:	ph[oe]be_a^ ne&c me& te_la^ pe^pu^le&ru&nt gra^du& 	X_^_X_^^^X_^X	1.0
Cum Phrygibus istos uicimus - tene horream	cu&m phry^gi^bu^s i_sto&s vi_ci^mu&s te&ne& ho_rre^a&m 	X^^^_X_^_X_^X	1.0
Aliena inerti tela iaculantem manu?	a^li^e_na& i^ne_rti& te_la^ ja^cu^la&nte&m ma^nu& 	^^_^_X_^^^X_^X	1.0
Quid si ipse mittat?' plura cum auderet furens,	qvi&d si& i_pse^ mi_tta&t plu_ra^ cu&m [au]de&re&t fu^re&ns 	X_^_X_^_X_^X	1.0
Tridente rupem subruit pulsam pater	tri&de_nte^ ru_pe&m su_bru^i&t pu&lsa&m pa^te&r 	X_^_X_^_X_^X	1.0
Neptunus imis exerens undis caput	ne&ptu_nu^s i_mi&s e_xe^re_ns u&ndi&s ca^pu&t 	X_^_X_^_X_^X	1.0
Soluitque montem; quem cadens secum tulit	so&lvi_tqve^ mo_nte&m qve&m ca^de&ns se&cu&m tu^li&t 	X_^_X_^_X_^X	1.0
Terraque et igne uictus et pelago iacet.	te&rra_qve& e^t i_gne& vi_ctu^s e&t pe^la^go_ ja^ce&t 	X_^_X_^_^^_^X	0.92
Nos alia maior naufragos pestis uocat.	no&s a^li^a^ ma_jo&r n[au]fra^go&s pe&sti&s vo^ca&t 	X^^^_X_^_X_^X	1.0
Est humilis unda, scrupeis mendax uadis,	e&st hu^mi^li^s u_nda& scru_pe^i&s me&nda&x va^di&s 	X^^^_X_^_X_^X	0.88
Vbi saxa rapidis clausa uerticibus tegit	u^bi^ sa_xa^ ra^pi^di&s cl[au]sa^ ve_rti^ci^bu&s te^gi&t 	^^_^^^X_^_^^_^X	1.0
Fallax Caphereus; aestuat scopulis fretum	fa&lla&x ca^phe_r[eu]s [ae]stu^a&t sco^pu^li&s fre^tu&m 	X_^_X_^_^^_^X	0.96
Feruetque semper fluctus alterna uice.	fe&rve_tqve^ se_mpe&r flu_ctu^s a_lte&rna_ vi^ce& 	X_^_X_^_X_^X	0.25
Arx imminet praerupta quae spectat mare	a&rx i_mmi^ne&t pr[ae]ru_pta^ qv[ae] spe&cta&t ma^re& 	X_^_X_^_X_^X	1.0
Vtrimque geminum: Pelopis hinc oras tui	u&tri_mqve^ ge^mi^nu&m pe^lo^pi^s hi&nc o&ra&s tu^i& 	X_^^^X^^^_X_^X	1.0
Et Isthmon, arto qui recuruatus solo	e&t i_sthmo^n, a_rto& qui_ re^cu_rua&tu&s so^lo&	X_^_X_^_X_^X	m
Ionia iungi maria Phrixeis uetat,	i&o_nja^ ju_ngi_ ma^ri^a^ phri_xe^i_s ue^ta&t,	X_^_X^^^_X_^X	c
Hinc scelere Lemnon nobilem, hinc Anthedona	hi&nc sce^le^re^ le_mno&n no_bi^le&m hi&nc a&nthe_do^na& 	X^^^_X_^_X_^X	1.0
Tardamque ratibus Aulida: hanc arcem occupat	ta&rda_mqve^ ra^ti^bu&s [au]li^da& ha&nc a&rce&m o_ccu^pa&t 	X_^^^X_^_X_^X	1.0
Palamedis ille genitor et clarum manu	pa^la^me_di^s i_lle& ge^ni^to^r e&t cla&ru&m ma^nu& 	^^_^_X^^^_X_^X	0.01
Lumen nefanda uertice e summo efferens	lu&me&n ne^fa_nda& ve_rti^ce& e_ su&mmo& e_ffe^re&ns 	X_^_X_^_X_^X	1.0
In saxa ducit perfida classem face.	i&n sa_xa^ du_ci&t pe_rfi^da_ cla&sse&m fa^ce& 	X_^_X_^_X_^X	1.0
Haerent acutis rupibus fixae rates;	h[ae]re&nt a^cu_ti&s ru_pi^bu&s fi&x[ae] ra^te&s 	X_^_X_^_X_^X	1.0
Has inopis undae breuia comminuunt uada,	ha&s i^no^pi^s u_nd[ae] bre^vi^a^ co_mmi^nu^u_nt va^da& 	X^^^_X^^^_^^_^X	1.0
Pars uehitur huius prima, pars scopulo sedet;	pa&rs ve^hi^tu^r hu_ju&s pri_ma^ pa&rs sco^pu^lo_ se^de&t 	X^^^_X_^_^^_^X	1.0
Hanc alia retro spatia relegentem ferit	ha&nc a^li^a^ re_tro& spa^ti^a^ re^le^ge&nte_m fe^ri&t 	X^^^_X^^^^^X_^X	0.65
Et fracta frangit. iam timent terram rates	e&t fra_cta^ fra_ngi&t ja&m ti^me&nt te&rra&m ra^te&s 	X_^_X_^_X_^X	1.0
Et maria malunt. cecidit in lucem furor:	e&t ma^ri^a^ ma_lu&nt ce^ci^di^t i&n lu&ce&m fu^ro&r 	X^^^_X^^^_X_^X	0.97
Postquam litatum est Ilio, Phoebus redit	po_stqua&m li^ta_tu&m e&st i_li^o&, ph[oe]bu&s re^di&t 	X_^_X_^_X_^X	m
Et damna noctis tristis ostendit dies.	e&t da_mna^ no_cti&s tri_sti^s o_ste&ndi&t di^e&s 	X_^_X_^_X_^X	1.0
Vtrumne doleam laeter an reducem uirum?	u&tru_mne^ do^le^a&m l[ae]te^r a&n re^du^ce&m vi^ru&m 	X_^^^X_^_^^_^X	1.0
Remeasse laetor, uulnus et regni graue	re^me^a_sse^ l[ae]to&r vu_lnu^s e&t re&gni& gra^ve& 	^^_^_X_^_X_^X	1.0
Lugere cogor. redde iam Grais, pater	lu&ge_re^ co_go&r re_dde^ ja&m gra&i&s pa^te&r 	X_^_X_^_X_^X	1.0
Altisona quatiens regna, placatos deos.	a&lti^so^na^ qva^ti^e&ns re_gna^ pla_ca&to&s de^o&s 	X^^^^^X_^_X_^X	1.0
Nunc omne laeta fronde ueletur caput,	nu&nc o_mne^ l[ae]ta& fro_nde^ ve_le&tu&r ca^pu&t 	X_^_X_^_X_^X	1.0
Sacrifica dulces tibia effundat modos	sa&cri^fi^ca^ du_lce&s ti_bi^a& e_ffu&nda&t mo^do&s 	X^^^_X_^_X_^X	1.0
Et niuea magnas uictima ante aras cadat.	e&t ni^ve^a^ ma_gna&s vi_cti^ma& a_nte& a&ra&s ca^da&t 	X^^^_X_^_X_^X	1.0
Sed ecce, turba tristis incomptae comas	se&d e_cce^ tu_rba& tri_sti^s i_nco&mptae_ co^ma&s 	X_^_X_^_X_^X	1.0
Iliades adsunt, quas super celso gradu	i_li^a^de^s a_dsu&nt, qua&s su^pe&r ce_lso& gra^du_ 	X^^^_X_^_X_^X	m
Effrena Phoebas entheas laurus quatit.	e&ffre_na^ ph[oe]ba&s e_nthe^a_s l[au]ru&s qva^ti&t 	X_^_X_^_X_^X	1.0
Cohibete lacrimas omne quas tempus petet,	co^hi^be_te^ la^cri^ma&s o_mne^ qva&s te&mpu&s pe^te&t 	^^_^^^X_^_X_^X	1.0
Troades, et ipsae uestra lamentabili	tro&a^de^s e^t i_ps[ae] ve_stra^ la_me&nta_bi^li& 	X^^^_X_^_X_^X	1.0
Lugete gemitu funera: aerumnae meae	lu&ge_te^ ge^mi^tu& fu_ne^ra& [ae]ru&mn[ae] me^[ae] 	X_^^^X_^_X_^X	1.0
Socium recusant. cladibus questus meis	so^ci^u&m re^cu_sa&nt cla_di^bu&s qve&stu&s me^i&s 	^^_^_X_^_X_^X	1.0
Remouete: nostris ipsa sufficiam malis.	re^mo^ve_te^ no_stri&s i_psa^ su_ffi^ci^a&m ma^li&s 	^^_^_X_^_^^_^X	0.92
Sed cur sacratas deripis capiti infulas?	se&d cu&r sa^cra_ta&s de_ri^pi&s ca^pi^ti& i_nfu^la&s 	X_^_X_^_^^_^X	0.25
Miseris colendos maxime superos putem.	mi^se^ri&s co^le_ndo&s ma_xi^me_ su^pe^ro&s pu^te&m.	^^_^_X_^_^^_^X	c
Vicere nostra iam metus omnis mala.	vi&ce_re^ no_stra& ja&m me^tu_s o&mni&s ma^la& 	X_^_X_^_X_^X	0.31
Equidem nec ulla caelites placo prece	e^qvi^de&m ne^c u_lla& c[ae]li^te_s pla&co& pre^ce& 	^^_^_X_^_X_^X	1.0
Nec, si uelint saeuire, quo noceant habent.	ne&c si_ ve^li&nt s[ae]vi_re^ qvo_ no^ce^a&nt ha^be&nt 	X_^_X_^_^^_^X	1.0
Fortuna uires ipsa consumpsit suas.	fo&rtu_na^ vi_re&s i_psa^ co_nsu&mpsi&t su^a&s 	X_^_X_^_X_^X	1.0
Quae patria restat, quis pater, quae iam soror?	qv[ae] pa^tri^a^ re_sta&t qvi&s pa^te&r qv[ae] ja&m so^ro&r 	X^^^_X_^_X_^X	0.95
Bibere tumuli sanguinem atque arae meum.	bi&be_re^ tu^mu^li& sa_ngvi^ne&m a_tqve& a&r[ae] me^u&m 	X_^^^X_^_X_^X	1.0
Quid illa felix turba fraterni gregis?	qvi&d i_lla^ fe_li&x tu_rba^ fra_te&rni& gre^gi&s 	X_^_X_^_X_^X	1.0
Exhausta nempe: regia miseri senes	e&xh[au]sta^ ne_mpe& re_gi^a_ mi^se^ri_ se^ne&s	X_^_X_^_^^_^X	m
Vacua relicti, totque per thalamos uident	va^cu^a_ re^li_cti& to_tqve^ pe&r tha^la^mo&s vi^de&nt	^^_^_X_^_^^_^X	m
Praeter Lacaenam ceteras uiduas nurus.	pr[ae]te&r la^c[ae]na&m ce_te^ra&s vi^du^a&s nu^ru&s	X_^_X_^_^^_^X	m
Tot illa regum mater et regimen Phrygum,	to&t i_lla^ re_gu&m ma_te^r e&t re^gi^me&n phry^gu&m	X_^_X_^_^^_^X	m
Fecunda in ignes Hecuba fatorum nouas	fe&cu_nda& i^n i_gne&s he^cu^ba^ fa_to&ru&m no^va&s 	X_^_X^^^_X_^X	1.0
Experta leges induit uultos feros:	e&xpe_rta^ le_ge&s i_ndu^i&t vu&lto_s fe^ro&s 	X_^_X_^_X_^X	0.96
Circa ruinas rabida latrauit suas,	ci&rca_ ru^i_na&s ra^bi^da^ la_tr[au]i&t su^a&s 	X_^_X^^^_X_^X	1.0
Troiae superstes, Hectori, Priamo, sibi.	tro&j[ae] su^pe_rste&s he_cto^ri& pri^a^mo_ si^bi&	X_^_X_^_^^_^X	m
Silet repente Phoebas et pallor genas	si&le&t re^pe_nte& ph[oe]ba^s e&t pa&llo&r ge^na&s 	X_^_X_^_X_^X	1.0
Creberque totum possidet corpus tremor;	cre&be_rqve^ to_tu&m po_ssi^de&t co&rpu&s tre^mo&r 	X_^_X_^_X_^X	1.0
Stetere uittae, mollis horrescit coma,	ste&te_re^ vi_tt[ae] mo_lli^s ho_rre&sci&t co^ma& 	X_^_X_^_X_^X	0.33
Anhela corda murmure incluso fremunt,	a&nhe_la^ co_rda& mu_rmu^re& i_nclu&so& fre^mu&nt 	X_^_X_^_X_^X	1.0
Incerta nutant lumina et uersi retro	i&nce_rta^ nu_ta&nt lu_mi^na& e&t ve&rsi_ re^tro& 	X_^_X_^_X_^X	0.35
Torquentur oculi, rursus immoti rigent.	to&rqve_ntu^r o^cu^li& ru_rsu^s i_mmo&ti_ ri^ge&nt 	X_^^^X_^_X_^X	1.0
Nunc leuat in auras altior solito caput	nu&nc le^va^t i^n [au]ra&s a_lti^o&r so^li^to_ ca^pu&t 	X^^^_X_^_^^_^X	1.0
Graditurque celsa, nunc reluctantis parat	gra^di^tu_rqve^ ce_lsa& nu&nc re^lu_cta&nti&s pa^ra&t 	^^_^_X_^_X_^X	1.0
Reserare fauces, uerba nunc clauso male	re^se^ra_re^ f[au]ce&s ve_rba^ nu&nc cl[au]so_ ma^le& 	^^_^_X_^_X_^X	1.0
Custodit ore maenas impatiens dei.	cu&sto_di^t o_re& m[ae]na^s i_mpa^ti^e&ns de^i& 	X_^_X_^_^^_^X	1.0
Quid me furoris incitam stimulis noui,	qvi&d me_ fu^ro_ri&s i_nci^ta&m sti^mu^li&s no^vi& 	X_^_X_^_^^_^X	0.64
Quid mentis inopem, sacra Parnasi iuga,	qvi&d me_nti^s i^no^pe&m sa_cra^ pa_rna&si_ ju^ga& 	X_^^^X_^_X_^X	0.97
Rapitis? recede, Phoebe, iam non sum tua,	ra^pi^ti&s re^ce_de& ph[oe]be^ ja&m no&n su&m tu^a& 	^^_^_X_^_X_^X	0.87
Extingue flammas pectori infixas meo.	e&xti_ngve^ fla_mma&s pe_cto^ri& i_nfi&xa&s me^o& 	X_^_X_^_X_^X	1.0
Cui nunc uagor uesana? cui bacchor furens?	cu&j nu&nc va^go&r ve&sa_na^ cu_j ba&ccho&r fu^re&ns 	X_^_X_^_X_^X	1.0
Iam Troia cecidit - falsa quid uates agor?	ja&m tro_ja^ ce^ci^di&t fa_lsa^ qvi&d va&te_s a^go&r 	X_^^^X_^_X_^X	0.66
Vbi sum? fugit lux alma et obscurat genas	u^bi^ su&m fu^gi&t lu&x a_lma& e^t o_bscu&ra&t ge^na&s 	^^_^_X_^_X_^X	0.76
Nox alta et aether abditus tenebris latet.	no&x a_lta& e^t [ae]the&r a_bdi^tu&s te^ne^bri&s la^te&t 	X_^_X_^_^^_^X	0.5
Sed ecce gemino sole praefulget dies	se&d e_cce^ ge^mi^no& so_le^ pr[ae]fu&lge&t di^e&s 	X_^^^X_^_X_^X	1.0
Geminumque duplices Argos attollit domus.	ge^mi^nu_mqve^ du^pli^ce&s a_rgo^s a_tto&lli&t do^mu&s 	^^_^^^X_^_X_^X	0.78
Idaea cerno nemora: fatalis sedet	i&d[ae]a^ ce_rno& ne^mo^ra^ fa_ta&li&s se^de&t 	X_^_X^^^_X_^X	1.0
Inter potentes arbiter pastor deas.	i&nte&r po^te_nte&s a_rbi^te&r pa&sto&r de^a&s 	X_^_X_^_X_^X	1.0
Timete, reges, moneo, furtiuum genus:	ti&me_te^, re_ge&s, mo^ne^o^, fu_rti_vu&m ge^nu^s: 	X_^_X^^^_X_^X	m
Agrestis iste alumnus euertet domum.	a&gre_sti^s i_ste& a&lu_mnu^s [eu]e&rte&t do^mu&m 	X_^_X_^_X_^X	1.0
Quid ista uecors tela feminea manu	qvi&d i_sta^ ve_co&rs te_la^ fe_mi^ne^a_ ma^nu&	X_^_X_^_^^_^X	m
Destricta praefert? quem petit dextra uirum	de&stri_cta^ pr[ae]fe&rt qve&m pe^ti&t de&xtra_ vi^ru&m 	X_^_X_^_X_^X	1.0
Lacaena cultu, ferrum Amazonium gerens?	la&c[ae]na^ cu_ltu& fe_rru&m a^ma_zo^ni^u_m ge^re&ns 	X_^_X_^_^^_^X	1.0
Quae uersat oculos alia nunc facies meos?	qv[ae] ve_rsa^t o^cu^lo&s a^li^a^ nu&nc fa^ci^e&s me^o&s 	X_^^^X^^^_^^_^X	1.0
Victor ferarum colla sublimis iacet	vi&cto&r fe^ra_ru&m co_lla^ su_bli&mi&s ja^ce&t 	X_^_X_^_X_^X	1.0
Ignobili sub dente Marmaricus leo,	i&gno_bi^li_ su&b de_nte^ ma_rma^ri^cu_s le^o& 	X_^_X_^_^^_^X	1.0
Morsus cruentos passus audacis leae.	mo&rsu&s cru^e_nto&s pa_ssu^s [au]da&ci&s le^[ae] 	X_^_X_^_X_^X	1.0
Quid me uocatis sospitem solam e meis,	qvi&d me_ vo^ca_ti&s so_spi^te_m so&la&m e_ me^i&s 	X_^_X_^_X_^X	1.0
Vmbrae meorum? te sequor, tota pater	u&mbr[ae] me^o_ru&m te_ se^qvo&r to&ta_ pa^te&r 	X_^_X_^_X_^X	1.0
Troia sepulte; frater, auxilium Phrygum	tro&ja_ se^pu_lte&; fra_te^r, [au]xi^li^u&m phry^gu&m 	X_^_X_^_^^_^X	m
Terrorque Danaum, non ego antiquum decus	te&rro_rqve^ da^na^u&m no_n e^go& a_nti&qvu&m de^cu&s 	X_^^^X_^_X_^X	1.0
Video aut calentes ratibus exustis manus,	vi^de^o& [au]t ca^le_nte&s ra^ti^bu^s e_xu&sti&s ma^nu&s 	^^_^_X^^^_X_^X	1.0
Sed lacera membra et saucios uinclo graui	se&d la^ce^ra^ me_mbra& e&t s[au]ci^o&s vi&nclo& gra^vi& 	X^^^_X_^_X_^X	1.0
Illos lacertos. te sequor, nimium cito	i&llo&s la^ce_rto&s te_ se^qvo&r ni^mi^u&m ci^to& 	X_^_X_^_^^_^X	1.0
Congresse Achilli Troile; incertos geris,	co_ngre_sse& a^chi_lli& tro_i^le&; i_nce_rto&s ge^ri&s, 	X_^_X_^_X_^X	m
Deiphobe, uultus, coniugis munus nouae.	de&i^pho^be^ vu_ltu&s co_nju^gi&s mu&nu&s no^v[ae] 	X^^^_X_^_X_^X	1.0
Iuuat per ipsos ingredi Stygios lacus,	ju&va&t pe^r i_pso&s i_ngre^di& sty^gi^o&s la^cu&s 	X_^_X_^_^^_^X	1.0
Iuuat uidere Tartari saeuum canem	ju&va&t vi^de_re& ta_rta^ri_ s[ae]vu&m ca^ne&m 	X_^_X_^_X_^X	0.34
Auidique regna Ditis! haec hodie ratis	a^vi^di_qve^ re_gna& di_ti^s h[ae]c ho^di^e_ ra^ti&s 	^^_^_X_^_^^_^X	1.0
Phlegethontis atri regias animas uehet,	phle^ge^tho_nti^s a_tri& re_gi^a_s a^ni^ma&s ve^he&t	^^_^_X_^_^^_^X	m
Victamque uictricemque. uos, umbrae, precor,	vi&cta_mqve^ vi_ctri&ce_mqve^ vo_s u&mbr[ae] pre^co&r 	X_^_X_^_X_^X	1.0
Iurata superis unda, te pariter precor:	ju&ra_ta^ su^pe^ri&s u_nda^ te_ pa^ri^te&r pre^co&r 	X_^^^X_^_^^_^X	1.0
Reserate paulum terga nigrantis poli,	re^se^ra_te^ p[au]lu&m te_rga^ ni_gra&nti&s po^li& 	^^_^_X_^_X_^X	1.0
Leuis ut Mycenas turba prospiciat Phrygum.	le^vi^s u&t my^ce_na&s tu_rba^ pro_spi^ci^a&t phry^gu&m 	^^_^_X_^_^^_^X	0.9
Spectate, miseri: fata se uertunt retro.	spe&cta_te^ mi^se^ri& fa_ta^ se_ ve&rtu&nt re^tro& 	X_^^^X_^_X_^X	0.35
Iam peruagatus ipse se fregit furor,	ja&m pe_rva^ga_tu&s i_pse^ se& fre&gi&t fu^ro&r 	X_^_X_^_X_^X	1.0
Caditque flexo qualis ante aras genu	ca&di_tqve^ fle_xo& qva_li^s a_nte& a&ra&s ge^nu& 	X_^_X_^_X_^X	1.0
Ceruice taurus uulnus incertum gerens.	ce&rvi_ce^ t[au]ru&s vu_lnu^s i_nce&rtu&m ge^re&ns 	X_^_X_^_X_^X	1.0
Releuemus artus. - En deos tandem suos	re^le^ve_mu^s a_rtu&s e&n de^o&s ta&nde&m su^o&s	^^_^_X_^_X_^X	m
Victrice lauru cinctus Agamemnon adit,	vi&ctri_ce^ l[au]ru& ci_nctu^s a^ga^me&mno_n a^di&t 	X_^_X_^^^X_^X	1.0
Et festa coniunx obuios illi tulit	e&t fe_sta^ co_nju&nx o_bvi^o_s i&lli_ tu^li&t 	X_^_X_^_X_^X	1.0
Gressus reditque iuncta concordi gradu.	gre&ssu&s re^di_tqve& ju_ncta^ co_nco&rdi& gra^du& 	X_^_X_^_X_^X	1.0
Tandem reuertor sospes ad patrios lares;	ta&nde&m re^ve_rto&r so_spe^s a&d pa^tri^o&s la^re&s 	X_^_X_^_^^_^X	1.0
O cara salue terra! tibi tot barbarae	o& ca_ra^ sa_lve& te_rra^ ti^bi^ to&t ba_rba^r[ae] 	X_^_X_^^^X_^X	0.85
Dedere gentes spolia, tibi felix diu	de&de_re^ ge_nte&s spo^li^a^ ti^bi^ fe&li&x di^u& 	X_^_X^^^^^X_^X	0.85
Potentis Asiae domina summisit manus.	po&te_nti^s a^si^[ae] do^mi^na^ su_mmi&si&t ma^nu&s 	X_^^^X^^^_X_^X	1.0
Quid ista uates corpus effusa ac tremens	qvi&d i_sta^ va_te&s co_rpu^s e_ffu&sa& a&c tre^me&ns 	X_^_X_^_X_^X	1.0
Dubia labat ceruice? famuli, attollite,	du^bi^a_ la^ba&t ce&rvi_ce^ fa^mu^li& a&tto_lli^te&	^^_^_X_^^^X_^X	m
Refouete gelido latice. iam recipit diem	re^fo^ve_te^ ge^li^do& la^ti^ce^ ja&m re^ci^pi&t di^e&m 	^^_^^^X^^^_^^_^X	1.0
Marcente uisu. Suscita sensus tuos:	ma&rce_nte^ vi_su& su_sci^ta_ se&nsu&s tu^o&s 	X_^_X_^_X_^X	1.0
Optatus ille portus aerumnis adest.	o&pta_tu^s i_lle& po_rtu^s [ae]ru&mni_s a^de&st 	X_^_X_^_X_^X	0.3
Festus dies est. Festus et Troiae fuit.	fe&stu&s di^e_s e&st fe_stu^s e&t tro&j[ae] fu^i&t 	X_^_X_^_X_^X	1.0
Veneremur aras. Cecidit ante aras pater.	ve^ne^re_mu^r a_ra&s ce^ci^di^t a_nte& a&ra&s pa^te&r	^^_^_X^^^_X_^X	m
Iouem precemur pariter. Herceum Iouem?	io&ue&m pre^ce_mu&r pa^ri^te^r.  he_rce^u_m io^ue&m? 	X_^_X^^^_X_^X	m
Credis uidere te Ilium? Et Priamum simul.	cre&di&s vi^de_re& te& i_li^u&m e&t pri^a^mu&m si^mu&l 	X_^_X_^_^^_^X	0.34
Hic Troia non est. Vbi Helena est, Troiam puta.	hi&c tro_ja^ no_n e&st u^bi& he^le^na& e&st tro&ja&m pu^ta& 	X_^_X^^^_X_^X	0.68
Ne metue dominam famula. Libertas adest.	ne& me^tu^e^ do^mi^na&m fa^mu^la^ li_be&rta_s a^de&st 	X^^^^^X^^^_X_^X	1.0
Secura uiue. Mihi mori est securitas.	se&cu_ra^ vi_ve& mi^hi^ mo^ri& e&st se&cu_ri^ta&s	X_^_X^^^_X_^X	m
Nullum est periclum tibimet. At magnum tibi.	nu&llu&m e&st pe^ri_clu&m ti^bi^me^t a&t ma&gnu&m ti^bi& 	X_^_X^^^_X_^X	1.0
Victor timere quid potest? Quod non timet.	vi&cto&r ti^me_re& qvi&d po^te&st qvo&d no&n ti^me&t 	X_^_X_^_X_^X	1.0
Hanc fida famuli turba, dum excutiat deum,	ha&nc fi_da^ fa^mu^li& tu_rba^ du&m e_xcu^ti^a&t de^u&m 	X_^^^X_^_^^_^X	1.0
Retinete ne quid impotens peccet furor.	re^ti^ne_te^ ne& qvi&d i_mpo^te_ns pe&cce&t fu^ro&r 	^^_^_X_^_X_^X	1.0
At te, pater, qui saeua torques fulmina	a&t te_ pa^te&r qvi& s[ae]va^ to_rqve&s fu_lmi^na& 	X_^_X_^_X_^X	1.0
Pellisque nubes, sidera et terras regis,	pe&lli_sqve^ nu_be&s si_de^ra& e&t te&rra&s re^gi&s 	X_^_X_^_X_^X	0.01
Ad quem triumphi spolia uictores ferunt,	a&d qve&m tri^u_mphi& spo^li^a^ vi_cto&re&s fe^ru&nt 	X_^_X^^^_X_^X	1.0
Et te sororem cuncta pollentis uiri,	e&t te_ so^ro_re&m cu_ncta^ po_lle&nti&s vi^ri& 	X_^_X_^_X_^X	1.0
Argolica Iuno, pecore uotiuo libens	a&rgo^li^ca^ ju_no& pe^co^re^ vo_ti&vo_ li^be&ns 	X^^^_X^^^_X_^X	1.0
Arabumque donis supplice et fibra colam.	a^ra^bu_mqve^ do_ni&s su_ppli^ce& e&t fi&bra_ co^la&m 	^^_^_X_^_X_^X	1.0
Res agitur intus magna, par annis decem.	re&s a^gi^tu^r i_ntu&s ma_gna^ pa_r a&nni&s de^ce&m 	X^^^_X_^_X_^X	1.0
Eheu quid hoc est? anime, consurge et cape	e&h[eu] qvi^d ho_c e&st a^ni^me^ co_nsu&rge& e&t ca^pe& 	X_^_X^^^_X_^X	1.0
Pretium furoris: uicimus uicti Phryges.	pre^ti^u&m fu^ro_ri&s vi_ci^mu&s vi&cti& phry^ge&s 	^^_^_X_^_X_^X	1.0
Bene est, resurgis Troia; traxisti iacens	be&ne& e&st re^su_rgi&s tro_ja^ tra_xi&sti_ ja^ce&ns 	X_^_X_^_X_^X	0.68
Pares Mycenas, terga dat uictor tuus!	pa&re&s my^ce_na&s te_rga^ da&t vi&cto&r tu^u&s 	X_^_X_^_X_^X	1.0
Tam clara numquam prouidae mentis furor	ta&m cla_ra^ nu_mqva&m pro_vi^dae_ me&nti&s fu^ro&r 	X_^_X_^_X_^X	1.0
Ostendit oculis: uideo et intersum et fruor;	o&ste_ndi^t o^cu^li&s vi^de^o& e^t i_nte&rsu&m e&t fru^o&r 	X_^^^X^^^_X_^X	1.0
Imago uisus dubia non fallit meos:	i&ma_go^ vi_su&s du^bi^a^ no&n fa&lli&t me^o&s 	X_^_X^^^_X_^X	1.0
Spectemus! epulae regia instructae domo,	spe&cte_mu^s e^pu^l[ae] re_gi^a& i_nstru&ctae_ do^mo& 	X_^^^X_^_X_^X	1.0
Quales fuerunt ultimae Phrygibus dapes,	qva&le&s fu^e_ru&nt u_lti^mae& phry^gi^bu&s da^pe&s 	X_^_X_^_^^_^X	1.0
Celebrantur: ostro lectus Iliaco nitet	ce^le^bra_ntu^r o_stro& le_ctu^s i_li^a^co_ ni^te&t 	^^_^_X_^_^^_^X	1.0
Merumque in auro ueteris Assaraci trahunt.	me&ru_mqve& i^n [au]ro& ve^te^ri^s a_ssa^ra^ci& tra^hu&nt 	X_^_X^^^_^^_^X	1.0
Et ipse picta ueste sublimis iacet,	e&t i_pse^ pi_cta& ve_ste^ su_bli&mi&s ja^ce&t 	X_^_X_^_X_^X	1.0
Priami superbas corpore exuuias gerens.	pri^a^mi_ su^pe_rba&s co_rpo^re& e_xu^vi^a&s ge^re&ns 	^^_^_X_^_^^_^X	1.0
Detrahere cultus uxor hostiles iubet,	de&tra^he^re^ cu_ltu&s u_xo^r ho_sti&le&s ju^be&t 	X^^^_X_^_X_^X	1.0
Induere potius coniugis fidae manu	i&ndu^e^re^ po^ti^u&s co_nju^gi&s fi&d[ae] ma^nu& 	X^^^^^X_^_X_^X	1.0
Textos amictus - horreo atque animo tremo:	te&xto_s a^mi_ctu&s ho_rre^o& a_tqve& a^ni^mo& tre^mo& 	X_^_X_^_^^_^X	1.0
Regemne perimet exul et adulter uirum?	re&ge_mne^ pe^ri^me&t e_xu^l e^t a^du&lte&r vi^ru&m 	X_^^^X_^^^X_^X	1.0
Venere fata. sanguinem extremae dapes	ve&ne_re^ fa_ta& sa_ngvi^ne&m e_xtre&m[ae] da^pe&s 	X_^_X_^_X_^X	0.94
Domini uidebunt et cruor Baccho incidet.	do^mi^ni_ vi^de_bu&nt e&t cru^o&r ba&ccho& i_nci^de&t 	^^_^_X_^_X_^X	0.96
Mortifera uinctum perfidae tradit neci	mo&rti^fe^ra^ vi_nctu&m pe_rfi^dae& tra&di&t ne^ci& 	X^^^_X_^_X_^X	1.0
Induta uestis: exitum manibus negant	i&ndu_ta^ ve_sti&s e_xi^tu&m ma^ni^bu&s ne^ga&nt 	X_^_X_^_^^_^X	0.66
Caputque laxi et inuii cludunt sinus.	ca&pu_tqve^ la_xi& e&t i_nvi^i& clu&du_nt si^nu&s 	X_^_X_^_X_^X	1.0
Haurit trementi semiuir dextra latus,	h[au]ri&t tre^me_nti& se_mi^vi&r de&xtra_ la^tu&s 	X_^_X_^_X_^X	0.98
Nec penitus egit: uulnere in medio stupet.	ne&c pe^ni^tu^s e_gi&t vu_lne^re& i&n me^di^o& stu^pe&t 	X^^^_X_^_^^_^X	1.0
At ille, ut altis hispidus siluis aper	a&t i_lle& u^t a_lti&s hi_spi^du&s si&lvi_s a^pe&r 	X_^_X_^_X_^X	1.0
Cum casse uinctus temptat egressus tamen	cu&m ca_sse^ vi_nctu&s te_mpta^t e_gre&ssu&s ta^me&n 	X_^_X_^_X_^X	1.0
Artatque motu uincla et in cassum furit,	a&rta_tqve^ mo_tu& vi_ncla& e^t i&n ca&ssu&m fu^ri&t 	X_^_X_^_X_^X	1.0
Cupit fluentes undique et caecos sinus	cu&pi&t flu^e_nte&s u_ndi^qve& e&t c[ae]co&s si^nu&s 	X_^_X_^_X_^X	1.0
Dissicere et hostem quaerit implicitus suum.	di&ssi^ce^re& e^t ho_ste&m qv[ae]ri^t i_mpli^ci^tu&s su^u&m 	X^^^_X_^_^^_^X	1.0
Armat bipenni Tyndaris dextram furens,	a&rma&t bi^pe_nni& ty_nda^ri&s de&xtra&m fu^re&ns 	X_^_X_^_X_^X	1.0
Qualisque ad aras colla taurorum prius	qva&li_sqve& a^d a_ra&s co_lla^ t[au]ro&ru&m pri^u&s 	X_^_X_^_X_^X	1.0
Sic huc et illuc impiam librat manum.	si&c hu_c e^t i_llu&c i_mpi^a&m li&bra&t ma^nu&m 	X_^_X_^_X_^X	1.0
Habet, peractum est. pendet exigua male	ha&be&t pe^ra_ctu&m e&st pe_nde^t e_xi^gu^a_ ma^le&	X_^_X_^_^^_^X	m
Caput amputatum parte et hinc trunco cruor	ca^pu^t a_mpu^ta_tu&m pa_rte& e^t hi&nc tru&nco& cru^o&r 	^^_^_X_^_X_^X	0.99
Exundat, illinc ora cum fremitu iacent.	e&xu_nda^t i_lli&nc o_ra^ cu&m fre^mi^tu_ ja^ce&nt 	X_^_X_^_^^_^X	1.0
Nondum recedunt: ille iam exanimem petit	no&ndu&m re^ce_du&nt i_lle^ ja&m e_xa^ni^me&m pe^ti&t 	X_^_X_^_^^_^X	1.0
Laceratque corpus, illa fodientem adiuuat.	la^ce^ra_tqve^ co_rpu&s i_lla^ fo^di^e&nte&m a_dju^va&t 	^^_^_X_^^^X_^X	1.0
Vterque tanto scelere respondet suis:	u&te_rqve^ ta_nto& sce^le^re^ re_spo&nde&t su^i&s 	X_^_X^^^_X_^X	1.0
Est hic Thyestae natus, haec Helenae soror.	e&st hi&c thy^e_st[ae] na_tu^s h[ae]c he^le^n[ae] so^ro&r 	X_^_X_^_^^_^X	1.0
Stat ecce Titan dubius emerito die,	sta&t e_cce^ ti_ta&n du^bi^u^s e_me^ri^to_ di^e& 	X_^_X^^^_^^_^X	1.0
Suane currat an Thyestea uia.	su^a_ne^ cu_rra_t a&n thy^e_ste^a_ ui^a&	X_^_X_^_X_^X	m
Fuge, o paternae mortis auxilium unicum,	fu&ge& o_ pa^te_rn[ae] mo_rti^s [au]xi^li^u&m u_ni^cu&m 	X_^_X_^_^^_^X	0.97
Fuge et scelestas hostium euita manus.	fu&ge& e&t sce^le_sta&s ho_sti^u&m e_vi&ta_ ma^nu&s 	X_^_X_^_X_^X	1.0
Euersa domus est funditus, regna occidunt.	[eu]e_rsa^ do^mu^s e&st fu_ndi^tu&s re&gna& o_cci^du&nt 	X_^^^X_^_X_^X	0.83
Quis iste celeres concitus currus agit?	qvi&s i_ste^ ce^le^re&s co_nci^tu&s cu&rru_s a^gi&t 	X_^^^X_^_X_^X	0.66
Germane, uultus ueste furabor tuos.	ge&rma_ne^ vu_ltu&s ve_ste^ fu_ra&bo_r tu^o&s 	X_^_X_^_X_^X	1.0
Quid, anime demens, refugis? externos times?	qvi&d a^ni^me^ de_me&ns re^fu^gi^s e_xte&rno&s ti^me&s 	X^^^_X^^^_X_^X	1.0
Domus timenda est. pone iam trepidos metus,	do&mu&s ti^me_nda& e&st po_ne^ ja&m tre^pi^do&s me^tu&s 	X_^_X_^_^^_^X	1.0
Oresta: amici fida praesidia intuor.	o&re_sta& a^mi_ci& fi_da^ pr[ae]si^di^a& i_ntu^o&r 	X_^_X_^_^^_^X	1.0
Phocide relicta Strophius Elea inclutus	pho&ci^de^ re^li_cta& stro^phi^u^s e_le&a& i_nclu^tu&s	X^^^_X^^^_X_^X	m
Palma reuertor. causa ueniendi fuit	pa&lma_ re^ve_rto&r c[au]sa^ ve^ni^e&ndi_ fu^i&t 	X_^_X_^^^X_^X	1.0
Gratari amico, cuius impulsum manu	gra&ta_ri& a^mi_co& cu_ju^s i_mpu&lsu&m ma^nu& 	X_^_X_^_X_^X	1.0
Cecidit decenni Marte concussum Ilium.	ce^ci^di&t de^ce_nni& ma_rte^ co_ncu&ssu&m i_li^u&m 	^^_^_X_^_X_^X	0.97
Quaenam ista lacrimis lugubrem uultum rigat	qv[ae]na&m i_sta^ la^cri^mi&s lu_gu^bre&m vu&ltu&m ri^ga&t 	X_^^^X_^_X_^X	1.0
Pauetque maesta? regium agnosco genus.	pa&ve_tqve^ m[ae]sta& re_gi^u&m a_gno&sco_ ge^nu&s 	X_^_X_^_X_^X	1.0
Electra, fletus causa quae laeta in domo est?	e&le_ctra^ fle_tu&s c[au]sa^ qv[ae] l[ae]ta& i&n do^mo& e&st 	X_^_X_^_X_^X	1.0
Pater peremptus scelere materno iacet,	pa&te&r pe^re_mptu&s sce^le^re^ ma_te&rno_ ja^ce&t 	X_^_X^^^_X_^X	1.0
Comes paternae quaeritur natus neci,	co&me&s pa^te_rn[ae] qv[ae]ri^tu&r na&tu&s ne^ci& 	X_^_X_^_X_^X	1.0
Aegisthus arces Venere quaesitas tenet.	[ae]gi_sthu^s a_rce&s ve^ne^re^ qv[ae]si&ta&s te^ne&t 	X_^_X^^^_X_^X	0.06
O nulla longi temporis felicitas!	o& nu_lla^ lo_ngi& te_mpo^ri&s fe&li_ci^ta&s 	X_^_X_^_X_^X	1.0
Per te parentis memoriam obtestor mei,	pe&r te_ pa^re_nti&s me^mo^ri^a&m o_bte&sto&r me^i& 	X_^_X^^^_X_^X	1.0
Per sceptra terris nota, per dubios deos:	pe&r sce_ptra^ te_rri&s no_ta^ pe&r du^bi^o&s de^o&s 	X_^_X_^_^^_^X	0.95
Recipe hunc Oresten ac pium furtum occule.	re^ci^pe& hu&nc o^re_ste&n a&c pi^u&m fu&rtu&m o_ccu^le& 	^^_^_X_^_X_^X	1.0
Etsi timendum caesus Agamemnon docet,	e&tsi_ ti^me_ndu&m c[ae]su^s a^ga^me&mno_n do^ce&t 	X_^_X_^^^X_^X	1.0
Aggrediar et te, Oresta, furabor libens.	a&ggre^di^a^r e&t te& o&re_sta^ fu_ra&bo_r li^be&ns 	X^^^_X_^_X_^X	1.0
Fidem secunda poscunt, aduersa exigunt	fi^de&m se^cu_nda& po_scu^nt, a_due_rsa& e_xi^gu&nt 	X_^_X_^_X_^X	m
Cape hoc decorum ludicri certaminis,	ca&pe& ho&c de^co_ru&m lu_di^cri_ ce&rta_mi^ni&s 	X_^_X_^_X_^X	1.0
Insigne frontis; laeua uictricem tenens	i&nsi_gne^ fro_nti&s l[ae]va^ vi_ctri&ce&m te^ne&ns 	X_^_X_^_X_^X	1.0
Frondem uirenti protegat ramo caput,	fro&nde&m vi^re_nti& pro_te^ga&t ra&mo_ ca^pu&t 	X_^_X_^_X_^X	1.0
Et ista donum palma Pisaei Iouis	e&t i_sta^ do_nu&m pa_lma^ pi_s[ae]i_ jo^vi&s 	X_^_X_^_X_^X	1.0
Velamen eadem praestet atque omen tibi.	ve&la_me^n e^a^de&m pr[ae]ste^t a_tqve& o&me&n ti^bi& 	X_^^^X_^_X_^X	0.93
Tuque, o paternis assidens frenis comes,	tu&qve& o_ pa^te_rni&s a_ssi^de_ns fre&ni&s co^me&s 	X_^_X_^_X_^X	1.0
Condisce, Pylade, patris exemplo fidem.	co&ndi_sce^ py^la^de& pa_tri^s e_xe&mplo_ fi^de&m 	X_^^^X_^_X_^X	0.45
Vos Graecia nunc teste ueloces equi	vo&s gr[ae]ci^a_ nu&nc te_ste^ ve_lo&ce_s e^qvi& 	X_^_X_^_X_^X	1.0
Infida cursu fugite praecipiti loca.	i&nfi_da^ cu_rsu& fu^gi^te^ pr[ae]ci^pi^ti_ lo^ca& 	X_^_X^^^_^^_^X	1.0
Excessit, abiit, currus effreno impetu	e&xce_ssi^t a^bi^i&t cu_rru^s e_ffre&no& i_mpe^tu& 	X_^^^X_^_X_^X	0.34
Effugit aciem. tuta iam opperiar meos	e&ffu_gi^t a^ci^e&m tu_ta^ ja&m o_ppe^ri^a&r me^o&s 	X_^^^X_^_^^_^X	0.27
Hostes et ultro uulneri opponam caput.	ho&ste_s e^t u_ltro& vu_lne^ri& o_ppo&na&m ca^pu&t 	X_^_X_^_X_^X	1.0
Adest cruenta coniugis uictrix sui,	a&de&st cru^e_nta& co_nju^gi&s vi&ctri&x su^i& 	X_^_X_^_X_^X	1.0
Et signa caedis ueste maculata gerit.	e&t si_gna^ c[ae]di&s ve_ste^ ma^cu^la&ta_ ge^ri&t 	X_^_X_^^^X_^X	1.0
Manus recenti sanguine etiamnunc madent	ma&nu&s re^ce_nti& sa_ngvi^ne& e^ti^a&mnu&nc ma^de&nt 	X_^_X_^^^X_^X	1.0
Vultusque prae se scelera truculenti ferunt.	vu&ltu_sqve^ pr[ae] se& sce^le^ra^ tru^cu^le&nti_ fe^ru&nt 	X_^_X^^^^^X_^X	1.0
Concedam ad aras. - Patere me uittis tuis,	co&nce_da&m a^d a_ra&s pa^te^re^ me_ vi&tti&s tu^i&s 	X_^_X^^^_X_^X	0.5
Cassandra, iungi paria metuentem tibi.	ca&ssa_ndra^ ju_ngi& pa^ri^a^ me^tu^e&nte&m ti^bi& 	X_^_X^^^^^X_^X	1.0
Hostis parentis, impium atque audax caput,	ho&sti&s pa^re_nti&s i_mpi^u&m a_tqve& [au]da&x ca^pu&t 	X_^_X_^_X_^X	1.0
Quo more coetus publicos uirgo petis?	qvo& mo_re^ c[oe]tu&s pu_bli^co_s vi&rgo_ pe^ti&s 	X_^_X_^_X_^X	0.53
Adulterorum uirgo deserui domum.	a&du_lte^ro_ru&m vi_rgo^ de_se^ru^i_ do^mu&m 	X_^_X_^_^^_^X	0.47
Quis esse credat uirginem - Gnatam tuam?	qvi&s e_sse^ cre_da&t vi_rgi^ne&m gna&ta_m tu^a&m 	X_^_X_^_X_^X	1.0
Modestius cum matre. Pietatem doces?	mo&de_sti^u_s cu&m ma_tre^ pi^e^ta&te&m do^ce&s 	X_^_X_^^^X_^X	1.0
Animos uiriles corde tumefacto geris;	a^ni^mo&s vi^ri_le&s co_rde^ tu^me^fa&cto_ ge^ri&s 	^^_^_X_^^^X_^X	1.0
Sed agere domita feminam disces malo.	se&d a^ge^re^ do^mi^ta& fe_mi^na&m di&sce&s ma^lo& 	X^^^^^X_^_X_^X	0.5
Nisi forte fallor, feminas ferrum decet.	ni^si^ fo_rte^ fa_llo&r fe_mi^na&s fe&rru&m de^ce&t 	^^_^_X_^_X_^X	0.97
Et esse demens te parem nobis putas?	e&t e_sse^ de_me&ns te_ pa^re&m no&bi&s pu^ta&s 	X_^_X_^_X_^X	1.0
Vobis? quis iste est alter Agamemnon tuus?	vo&bi&s qvi^s i_ste& e&st a_lte^r a^ga^me&mno_n tu^u&s 	X_^_X_^^^X_^X	0.76
Vt uidua loquere: uir caret uita tuus.	u&t vi^du^a^ lo^qve^re& vi&r ca^re&t vi&ta_ tu^u&s	X^^^^^X_^_X_^X	m
Indomita posthac uirginis uerba impiae	i&ndo^mi^ta^ po_stha&c vi_rgi^ni&s ve&rba& i_mpi^ae& 	X^^^_X_^_X_^X	1.0
Regina frangam; citius interea mihi	re&gi_na^ fra_nga&m ci^ti^u^s i_nte^re^a_ mi^hi&	X_^_X^^^_^^_^X	m
Edissere ubi sit gnatus, ubi frater tuus.	e&di_sse^re& u^bi^ si&t gna_tu^s u^bi^ fra&te&r tu^u&s	X_^^^X_^^^X_^X	m
Extra Mycenas. Redde nunc gnatum mihi.	e&xtra_ my^ce_na&s re_dde^ nu&nc gna&tu_m mi^hi& 	X_^_X_^_X_^X	1.0
Et tu parentem redde. Quo latitat loco?	e&t tu_ pa^re_nte&m re_dde^ qvo_ la^ti^ta&t lo^co&	X_^_X_^_^^_^X	m
Tuto quietus, regna non metuens noua:	tu&to& qvi^e_tu&s re_gna^ no&n me^tu^e&ns no^va& 	X_^_X_^_^^_^X	1.0
Iustae parenti satis. At iratae parum.	ju&st[ae] pa^re_nti& sa^ti^s a^t i_ra&tae_ pa^ru&m	X_^_X^^^_X_^X	m
Morieris hodie. Dummodo hac moriar manu.	mo^ri^e_ri^s ho^di^e& du_mmo^do& ha&c mo^ri^a&r ma^nu&	^^_^^^X_^_^^_^X	m
Recedo ab aris. siue te iugulo iuuat	re&ce_do& a^b a_ri&s si_ve^ te_ ju^gu^lo_ ju^va&t 	X_^_X_^_^^_^X	1.0
Mersisse ferrum, praebeo iugulum tibi;	me&rsi_sse^ fe_rru&m pr[ae]be^o_ ju^gu^lu&m ti^bi&	X_^_X_^_^^_^X	m
Seu more pecudum colla resecari placet,	s[eu] mo_re^ pe^cu^du&m co_lla^ re^se^ca&ri& pla^ce&t 	X_^^^X_^^^X_^X	0.97
Intenta ceruix uulnus expectat tuum.	i&nte_nta^ ce_rvi&x vu_lnu^s e_xpe&cta&t tu^u&m 	X_^_X_^_X_^X	1.0
Scelus paratum est: caede respersam uiri	sce&lu&s pa^ra_tu&m e&st c[ae]de^ re_spe&rsa&m vi^ri& 	X_^_X_^_X_^X	1.0
Atque obsoletam sanguine hoc dextram ablue.	a&tqve& o_bso^le_ta&m sa_ngvi^ne& ho&c de&xtra&m a_blu^e& 	X_^_X_^_X_^X	1.0
Consors pericli pariter ac regni mei,	co&nso&rs pe^ri_cli& pa^ri^te^r a&c re&gni_ me^i& 	X_^_X^^^_X_^X	1.0
Aegisthe, gradere. gnata genetricem impie	[ae]gi_sthe^ gra^de^re& gna_ta^ ge^ne^tri&ce&m i_mpi^e& 	X_^^^X_^^^X_^X	1.0
Probris lacessit, occulit fratrem abditum.	pro&bri&s la^ce_ssi&t o_ccu^li&t fra&tre&m a_bdi^tu&m 	X_^_X_^_X_^X	1.0
Furibunda uirgo, uocis infandae sonum	fu^ri^bu_nda^ vi_rgo& vo_ci^s i_nfa&nd[ae] so^nu&m 	^^_^_X_^_X_^X	1.0
Et aure uerba indigna materna opprime.	e&t [au]re^ ve_rba& i&ndi_gna^ ma_te&rna& o_ppri^me& 	X_^_X_^_X_^X	1.0
Etiam monebit sceleris infandi artifex,	e^ti^a&m mo^ne_bi&t sce^le^ri^s i_nfa&ndi& a_rti^fe&x 	^^_^_X^^^_X_^X	1.0
Per scelera natus, nomen ambiguum suis,	pe&r sce^le^ra^ na_tu&s no_me^n a_mbi^gu^u&m su^i&s 	X^^^_X_^_^^_^X	1.0
Idem sororis gnatus et patris nepos?	i&de&m so^ro_ri&s gna_tu^s e&t pa&tri&s ne^po&s 	X_^_X_^_X_^X	1.0
Aegisthe, cessas impium ferro caput	[ae]gi_sthe^ ce_ssa&s i_mpi^u&m fe&rro_ ca^pu&t 	X_^_X_^_X_^X	1.0
Demetere? fratrem reddat aut animam statim.	de&me^te^re^ fra_tre&m re_dda^t [au]t a^ni^ma&m sta^ti&m	X^^^_X_^_^^_^X	m
Abstrusa caeco carcere et saxo exigat	a&bstru_sa^ c[ae]co& ca_rce^re& e&t sa&xo& e_xi^ga&t 	X_^_X_^_X_^X	1.0
Aeuum; per omnes torta poenarum modos	[ae]vu&m pe^r o_mne&s to_rta^ p[oe]na&ru&m mo^do&s 	X_^_X_^_X_^X	1.0
Referre quem nunc occulit forsan uolet.	re&fe_rre^ qve&m nu&nc o_ccu^li&t fo&rsa&n vo^le&t 	X_^_X_^_X_^X	1.0
Inops egens inclusa, paedore obruta,	i&no&ps e^ge&ns i&nclu_sa^ p[ae]do&re& o_bru^ta& 	X_^_X_^_X_^X	1.0
Vidua ante thalamos, exul, inuisa omnibus	vi^du^a& a_nte^ tha^la^mo&s e_xu^l i_nvi&sa& o_mni^bu&s 	^^_^^^X_^_X_^X	1.0
Aethere negato sero subcumbet malis.	[ae]the^re^ ne^ga_to& se_ro^ su_bcu&mbe_t ma^li&s 	X^^^_X_^_X_^X	0.28
Concede mortem. Si recusares, darem:	co&nce_de^ mo_rte&m si_ re^cu_sa&re&s da^re&m 	X_^_X_^_X_^X	1.0
Rudis est tyrannus morte qui poenam exigit.	ru^di^s e&st ty^ra_nnu&s mo_rte^ qvi_ p[oe]na&m e_xi^gi&t 	^^_^_X_^_X_^X	1.0
Mortem aliquid ultra est? Vita, si cupias mori. -	mo&rte&m a^li^qvi^d u_ltra& e&st vi_ta^ si_ cu^pi^a&s mo^ri& 	X^^^_X_^_^^_^X	1.0
Abripite, famuli, monstrum et auectam procul	a&bri^pi^te^ fa^mu^li& mo_nstru&m e^t [au]e&cta&m pro^cu&l 	X^^^^^X_^_X_^X	1.0
Vltra Mycenas ultimo in regni angulo	u&ltra_ my^ce_na&s u_lti^mo& i&n re&gni& a_ngu^lo& 	X_^_X_^_X_^X	1.0
Vincite saeptam nocte tenebrosi specus,	vi&nci_te^ s[ae]pta&m no_cte^ te^ne^bro&si& spe^cu&s 	X_^_X_^^^X_^X	0.17
Vt inquietam uirginem carcer domet.	u&t i_nqvi^e_ta&m vi_rgi^ne&m ca&rce&r do^me&t 	X_^_X_^_X_^X	1.0
At ista poenas capite persoluet suo	a&t i_sta^ p[oe]na&s ca^pi^te^ pe_rso&lve&t su^o& 	X_^_X^^^_X_^X	1.0
Captiua coniunx, regii paelex tori.	ca&pti_va^ co_nju&nx re_gi^i_ p[ae]le&x to^ri& 	X_^_X_^_X_^X	1.0
Trahite, ut sequatur coniugem ereptum mihi.	tra^hi^te& u&t se^qva_tu&r co_nju^ge&m e_re&ptu&m mi^hi& 	^^_^_X_^_X_^X	1.0
Ne trahite, uestros ipsa praecedam gradus.	ne& tra^hi^te^ ve_stro&s i_psa^ pr[ae]ce&da&m gra^du&s 	X^^^_X_^_X_^X	1.0
Perferre prima nuntium Phrygibus meis	pe&rfe_rre^ pri_ma& nu_nti^u_m phry^gi^bu&s me^i&s 	X_^_X_^_^^_^X	1.0
Propero: repletum ratibus euersis mare,	pro^pe^ro_ re^ple_tu&m ra^ti^bu^s [eu]e&rsi&s ma^re&	^^_^_X^^^_X_^X	m
Captas Mycenas, mille ductorem ducum,	ca&pta&s my^ce_na&s mi_lle^ du_cto&re&m du^cu&m 	X_^_X_^_X_^X	1.0
Vt paria fata Troicis lueret malis,	u&t pa^ri^a^ fa_ta& tro_i^ci&s lu^e^re&t ma^li&s, 	X^^^_X_^_^^_^X	m
Perisse dono, feminae stupro, dolo.	pe&ri_sse^ do_no& fe_mi^nae& stu&pro_ do^lo& 	X_^_X_^_X_^X	1.0
Nihil moramur, rapite, quin grates ago:	ni&hi&l mo^ra_mu&r ra^pi^te^ qvi&n gra&te_s a^go& 	X_^_X^^^_X_^X	1.0
Iam, iam iuuat uixisse post Troiam, iuuat.	ja&m ja&m ju^va&t vi&xi_sse^ po&st tro&ja&m ju^va&t 	X_^_X_^_X_^X	1.0
Furiosa, morere. Veniet et uobis furor.	fu^ri^o_sa^ mo^re^re& ve^ni^e^t e&t vo&bi&s fu^ro&r 	^^_^^^X^^^_X_^X	1.0
