/*
Created by Aleksandr Fedchin on 10/1/2019.
This is the complete scansion of trimeter sections of Seneca's Hercules furens
The edition used is that of O. Zwierlein, 1986, source:mqdq.it
Estimated accuracy: 98%

Each line contains a verse from the original text, a list of words from that
verse with their inferred scansions, the scansion itself, and one of the
following tags:
    'm' - if the line was manually scanned
    'v' - if automatically produced scansion was manually verified
    'c' - if automatically produced scansion was corrected
    'u' - if the line was left unscanned
    confidence score that the program assigns to the line (higher=better)

Key:
X - monosyllabic anceps (can also be marked as _ or ^ wherever the line is
	scanned manually)
_ - long syllable
^ - short syllable
& - the quantity is unknown (for elided syllables, anceps syllables,
	or syllables long by position)
Resolution rate: 0.765
Resolution rate in lines in which speakers remain the same: 0.754
Resolution rate in lines in which speakers change: 1.056
*/

Soror Tonantis (hoc enim solum mihi	so&ro&r to^na_nti&s ho_c e^ni&m so&lu&m mi^hi& 	X_^_X_^_X_^X	1.0
Nomen relictum est) semper alienum Iouem	no&me&n re^li_ctu&m e&st se_mpe^r a^li^e&nu&m jo^ve&m 	X_^_X_^^^X_^X	1.0
Ac templa summi uidua deserui aetheris	a&c te_mpla^ su_mmi& vi^du^a^ de_se^ru^i& [ae]the^ri&s 	X_^_X^^^_^^_^X	1.0
Locumque caelo pulsa paelicibus dedi;	lo&cu_mqve^ c[ae]lo& pu_lsa^ p[ae]li^ci^bu_s de^di& 	X_^_X_^_^^_^X	0.95
Tellus colenda est, paelices caelum tenent:	te&llu&s co^le_nda& e&st p[ae]li^ce_s c[ae]lu&m te^ne&nt 	X_^_X_^_X_^X	1.0
Hinc Arctos alta parte glacialis poli	hi&nc a_rcto^s a_lta& pa_rte^ gla^ci^a&li&s po^li& 	X_^_X_^^^X_^X	1.0
Sublime classes sidus Argolicas agit;	su&bli_me^ cla_sse&s si_du^s a_rgo^li^ca_s a^gi&t 	X_^_X_^_^^_^X	1.0
Hinc, qua recenti uere laxatur dies,	hi&nc qva_ re^ce_nti& ve_re^ la_xa&tu&r di^e&s 	X_^_X_^_X_^X	0.87
Tyriae per undas uector Europae nitet;	ty^ri^[ae] pe^r u_nda&s ve_cto^r [eu]ro&p[ae] ni^te&t 	^^_^_X_^_X_^X	1.0
Illinc timendum ratibus ac ponto gregem	i&lli&nc ti^me_ndu&m ra^ti^bu^s a&c po&nto& gre^ge&m 	X_^_X^^^_X_^X	1.0
Passim uagantes exerunt Atlantides;	pa&ssi&m va^ga_nte&s e_xe^ru&nt a&tla_nti^de&s 	X_^_X_^_X_^X	1.0
Ferro minax hinc terret Orion deos	fe&rro_ mi^na&x hi&nc te_rre^t o_ri&o&n de^o&s 	X_^_X_^_X_^X	0.36
Suasque Perseus aureus stellas habet;	su&a_sqve^ pe_rs[eu]s [au]re^u&s ste&lla_s ha^be&t 	X_^_X_^_X_^X	1.0
Hinc clara gemini signa Tyndaridae micant	hi&nc cla_ra^ ge^mi^ni& si_gna^ ty_nda^ri^d[ae] mi^ca&nt 	X_^^^X_^_^^_^X	1.0
Quibusque natis mobilis tellus stetit.	qvi&bu_sqve^ na_ti&s mo_bi^li&s te&llu&s ste^ti&t 	X_^_X_^_X_^X	1.0
Nec ipse tantum Bacchus aut Bacchi parens	ne&c i_pse^ ta_ntu&m ba_cchu^s [au]t ba&cchi_ pa^re&ns 	X_^_X_^_X_^X	0.97
Adiere superos: ne qua pars probro uacet,	a^di^e_re^ su^pe^ro&s ne& qva^ pa&rs pro&bro_ va^ce&t 	^^_^^^X_^_X_^X	1.0
Mundus puellae serta Cnosiacae gerit.	mu_ndu&s pu^e_ll[ae] se_rta^ cno_si^a^c[ae] ge^ri&t. 	X_^_X_^_^^_^X	m
Thebana tellus matribus sparsa impiis	the&ba_na^ te_llu&s ma_tri^bu&s spa&rsa& i_mpi^i&s 	X_^_X_^_X_^X	1.0
Quotiens nouercam fecit! escendat licet	qvo^ti^e&ns no^ve_rca&m fe_ci^t e_sce&nda&t li^ce&t 	^^_^_X_^_X_^X	1.0
Meumque uictrix teneat Alcmene locum,	me&u_mqve^ vi_ctri&x te^ne^a^t a_lcme&ne_ lo^cu&m 	X_^_X^^^_X_^X	1.0
Pariterque natus astra promissa occupet,	pa^ri^te_rqve^ na_tu&s a_stra^ pro_mi&ssa& o_ccu^pe&t 	^^_^_X_^_X_^X	1.0
In cuius ortus mundus impendit diem	i&n cu_ju^s o_rtu&s mu_ndu^s i_mpe&ndi&t di^e&m 	X_^_X_^_X_^X	1.0
Tardusque Eoo Phoebus effulsit mari	ta&rdu_sqve& e^o_o& ph[oe]bu^s e_ffu&lsi&t ma^ri& 	X_^_X_^_X_^X	0.65
Retinere mersum iussus Oceano iubar?	re^ti^ne_re^ me_rsu&m ju_ssu^s o_ce^a^no_ ju^ba&r 	^^_^_X_^_^^_^X	1.0
Non sic abibunt odia; uiuaces aget	no&n si_c a^bi_bu&nt o^di^a^; ui_ua&ce_s a^ge&t 	X_^_X^^^_X_^X	m
Violentus iras animus et saeuus dolor	vi^o^le_ntu^s i_ra&s a^ni^mu^s e&t s[ae]vu&s do^lo&r 	^^_^_X^^^_X_^X	1.0
Aeterna bella pace sublata geret.	[ae]te_rna^ be_lla& pa_ce^ su_bla&ta_ ge^re&t 	X_^_X_^_X_^X	1.0
Quae bella? quidquid horridum tellus creat	qv[ae] be_lla^ qvi_dqvi&d ho_rri^du&m te&llu&s cre^a&t 	X_^_X_^_X_^X	1.0
Inimica, quidquid pontus aut aer tulit	i^ni^mi_ca^ qvi_dqvi&d po_ntu^s [au]t a&e&r tu^li&t 	^^_^_X_^_X_^X	1.0
Terribile dirum pestilens atrox ferum,	te&rri^bi^le^ di_ru&m pe_sti^le_ns a&tro&x fe^ru&m 	X^^^_X_^_X_^X	1.0
Fractum atque domitum est. superat et crescit malis	fra&ctu&m a_tqve^ do^mi^tu&m e&st su^pe^ra^t e&t cre&sci&t ma^li&s 	X_^^^X^^^_X_^X	0.92
Iraque nostra fruitur; in laudes suas	i&ra_qve^ no_stra& fru^i^tu^r i&n l[au]de&s su^a&s 	X_^_X^^^_X_^X	1.0
Mea uertit odia: dum nimis saeua impero,	me^a^ ve_rti^t o^di^a& du&m ni^mi&s s[ae]va& i_mpe^ro& 	^^_^^^X_^_X_^X	1.0
Patrem probaui, gloriae feci locum.	pa&tre&m pro^b[au]i& glo_ri^[ae] fe&ci_ lo^cu&m 	X_^_X_^_X_^X	1.0
Qua Sol reducens quaque deponens diem	qva& so&l re^du_ce&ns qva_qve^ de_po&ne_ns di^e&m 	X_^_X_^_X_^X	1.0
Binos propinqua tinguit Aethiopas face,	bi&no&s pro^pi_nqva& ti_ngvi^t [ae]thi^o^pa_s fa^ce& 	X_^_X_^_^^_^X	1.0
Indomita uirtus colitur et toto deus	i&ndo^mi^ta^ vi_rtu&s co^li^tu^r e&t to&to_ de^u&s 	X^^^_X^^^_X_^X	1.0
Narratur orbe. monstra iam desunt mihi	na&rra_tu^r o_rbe& mo_nstra^ ja&m de&su&nt mi^hi& 	X_^_X_^_X_^X	1.0
Minorque labor est Herculi iussa exequi,	mi&no_rqve^ la^bo^r e&st he_rcu^li_ ju&ssa& e_xe^qvi& 	X_^^^X_^_X_^X	0.97
Quam mihi iubere: laetus imperia excipit.	qva&m mi^hi^ ju^be_re& l[ae]tu^s i_mpe^ri^a& e_xci^pi&t 	X^^^_X_^_^^_^X	0.81
Quae fera tyranni iussa uiolento queant	qv[ae] fe^ra^ ty^ra_nni& ju_ssa^ vi^o^le&nto& qve^a&nt 	X^^^_X_^^^X_^X	1.0
Nocere iuueni? nempe pro telis gerit	no&ce_re^ ju^ve^ni& ne_mpe^ pro_ te&li&s ge^ri&t 	X_^^^X_^_X_^X	1.0
Quae timuit et quae fudit: armatus uenit	qv[ae] ti^mu^i^t e&t qv[ae] fu_di^t a_rma&tu&s ve^ni&t 	X^^^_X_^_X_^X	0.57
Leone et hydra. Nec satis terrae patent:	le&o_ne& e^t hy_dra& ne&c sa^ti&s te&rr[ae] pa^te&nt 	X_^_X_^_X_^X	1.0
Effregit ecce limen inferni Iouis	e&ffre_gi^t e_cce& li_me^n i_nfe&rni_ jo^vi&s 	X_^_X_^_X_^X	1.0
Et opima uicti regis ad superos refert.	e^t o^pi_ma^ vi_cti& re_gi^s a&d su^pe^ro&s re^fe&rt 	^^_^_X_^_^^_^X	0.91
Parum est reuerti, foedus umbrarum perit:	pa&ru&m e&st re^ve_rti& f[oe]du^s u_mbra&ru&m pe^ri&t 	X_^_X_^_X_^X	1.0
Vidi ipsa, uidi nocte discussa inferum	vi&di& i_psa^ vi_di& no_cte^ di_scu&ssa& i_nfe^ru&m 	X_^_X_^_X_^X	1.0
Et Dite domito spolia iactantem patri	e&t di_te^ do^mi^to& spo^li^a^ ja_cta&nte&m pa^tri& 	X_^^^X^^^_X_^X	0.54
Fraterna. cur non uinctum et oppressum trahit	fra&te_rna^ cu&r no&n vi_nctu&m e^t o_ppre&ssu&m tra^hi&t 	X_^_X_^_X_^X	1.0
Ipsum catenis paria sortitum Ioui	i&psu&m ca^te_ni&s pa^ri^a^ so_rti&tu&m jo^vi& 	X_^_X^^^_X_^X	1.0
Ereboque capto potitur? en retegit Styga!	e^re^bo_qve^ ca_pto& po^ti^tu^r e&n re^te^gi&t sty^ga& 	^^_^_X^^^_^^_^X	1.0
Patefacta ab imis manibus retro uia est	pa^te^fa_cta& a^b i_mi&s ma_ni^bu&s re&tro_ vi^a& e&st 	^^_^_X_^_X_^X	0.34
Et sacra dirae mortis in aperto iacent.	e&t sa_cra^ di_r[ae] mo_rti^s i^n a^pe&rto_ ja^ce&nt 	X_^_X_^^^X_^X	0.94
At ille, rupto carcere umbrarum ferox,	a&t i_lle^ ru_pto& ca_rce^re& u_mbra&ru&m fe^ro&x 	X_^_X_^_X_^X	1.0
De me triumphat et superbifica manu	de& me& tri^u_mpha&t e&t su^pe_rbi^fi^ca_ ma^nu&	X_^_X_^_^^_^X	m
Atrum per urbes ducit Argolicas canem.	a&tru&m pe^r u_rbe&s du_ci^t a_rgo^li^ca&s ca^ne&m 	X_^_X_^_^^_^X	1.0
Viso labantem Cerbero uidi diem	vi&so_ la^ba_nte&m ce_rbe^ro_ vi&di_ di^e&m 	X_^_X_^_X_^X	1.0
Pauidumque Solem; me quoque inuasit tremor,	pa^vi^du_mqve^ so_le&m me& qvo^qve& i_nva&si&t tre^mo&r 	^^_^_X_^_X_^X	0.93
Et terna monstri colla deuicti intuens	e&t te_rna^ mo_nstri& co_lla^ d[eu]i&cti& i_ntu^e&ns 	X_^_X_^_X_^X	1.0
Timui imperasse. Leuia sed nimium queror;	ti^mu^i& i_mpe^ra_sse& le^vi^a^ se&d ni^mi^u&m qve^ro&r 	^^_^_X^^^_^^_^X	0.5
Caelo timendum est, regna ne summa occupet	c[ae]lo_ ti^me_ndu&m e&st re_gna^ ne_ su&mma& o_ccu^pe&t 	X_^_X_^_X_^X	1.0
Qui uicit ima: sceptra praeripiet patri.	qvi& vi_ci^t i_ma& sce_ptra^ pr[ae]ri^pi^e&t pa^tri& 	X_^_X_^_^^_^X	0.54
Nec in astra lenta ueniet ut Bacchus uia:	ne^c i^n a_stra^ le_nta& ve^ni^e^t u&t ba&cchu&s vi^a& 	^^_^_X^^^_X_^X	1.0
Iter ruina quaeret et uacuo uolet	i&te&r ru^i_na& qv[ae]re^t e&t va^cu^o_ vo^le&t 	X_^_X_^_^^_^X	1.0
Regnare mundo. robore experto tumet,	re&gna_re^ mu_ndo& ro_bo^re& e_xpe&rto_ tu^me&t 	X_^_X_^_X_^X	1.0
Et posse caelum uiribus uinci suis	e&t po_sse^ c[ae]lu&m vi_ri^bu&s vi&nci& su^i&s 	X_^_X_^_X_^X	1.0
Didicit ferendo; subdidit mundo caput	di^di^ci&t fe^re_ndo& su_bdi^di&t mu&ndo_ ca^pu&t 	^^_^_X_^_X_^X	1.0
Mediusque collo sedit Herculeo polus	me^di^u_sqve^ co_llo& se_di^t he_rcu^le^o_ po^lu&s 	^^_^_X_^_^^_^X	1.0
Nec flexit umeros molis immensae labor;	ne&c fle_xi^t u^me^ro&s mo_li^s i_mme&ns[ae] la^bo&r 	X_^^^X_^_X_^X	0.97
Immota ceruix sidera et caelum tulit	i&mmo_ta^ ce_rvi&x si_de^ra& e&t c[ae]lu&m tu^li&t 	X_^_X_^_X_^X	1.0
Et me prementem: quaerit ad superos uiam.	e&t me& pre^me_nte&m qv[ae]ri^t a&d su^pe^ro&s vi^a&m 	X_^_X_^_^^_^X	1.0
Perge, ira, perge et magna meditantem opprime,	pe&rge& i_ra^ pe_rge& e&t ma_gna^ me^di^ta&nte&m o_ppri^me& 	X_^_X_^^^X_^X	1.0
Congredere, manibus ipsa dilacera tuis:	co&ngre^de^re^ ma^ni^bu&s i_psa^ di_la^ce^ra_ tu^i&s	X^^^^^X_^_^^_^X	m
Quid tanta mandas odia? discedant ferae,	qvi&d ta_nta^ ma_nda&s o^di^a^ di_sce&da&nt fe^r[ae] 	X_^_X^^^_X_^X	1.0
Ipse imperando fessus Eurystheus uacet.	i&pse& i_mpe^ra_ndo& fe_ssu^s [eu]ry&sth[eu]s va^ce&t 	X_^_X_^_X_^X	1.0
Titanas ausos rumpere imperium Iouis	ti&ta_na^s [au]so&s ru_mpe^re& i_mpe^ri^u&m jo^vi&s 	X_^_X_^_^^_^X	1.0
Emitte, Siculi uerticis laxa specum,	e&mi_tte^ si^cu^li& ve_rti^ci&s la&xa& spe^cu&m 	X_^^^X_^_X_^X	1.0
Tellus gigante Doris excusso tremens	te&llu&s gi^ga_nte& do_ri^s e_xcu&sso& tre^me&ns 	X_^_X_^_X_^X	1.0
Supposita monstri colla terrifici leuet,	su&ppo^si^ta^ mo_nstri& co_lla^ te_rri^fi^ci_ le^ve&t 	X^^^_X_^_^^_^X	1.0
Sublimis alias Luna concipiat feras -	su&bli_mi^s a^li^a&s lu_na^ co_nci^pi^a&t fe^ra&s 	X_^^^X_^_^^_^X	0.97
Sed uicit ista. quaeris Alcidae parem?	se&d vi_ci^t i_sta& qv[ae]ri^s a_lci&d[ae] pa^re&m 	X_^_X_^_X_^X	1.0
Nemo est nisi ipse: bella iam secum gerat.	ne&mo& e&st ni^si& i_pse& be_lla^ ja&m se&cu&m ge^ra&t 	X_^_X_^_X_^X	0.97
Adsint ab imo Tartari fundo excitae	a_dsi&nt a^b i_mo_ ta_rta^ri_ fu_ndo& e_xci^t[ae] 	X_^_X_^_X_^X	m
Eumenides, ignem flammeae spargant comae,	[eu]me^ni^de^s i_gne&m fla_mme^ae& spa&rga&nt co^m[ae] 	X^^^_X_^_X_^X	1.0
Viperea saeuae uerbera incutiant manus.	vi&pe^re^a^ s[ae]v[ae] ve_rbe^ra& i_ncu^ti^a&nt ma^nu&s 	X^^^_X_^_^^_^X	1.0
I nunc, superbe, caelitum sedes pete,	i& nu&nc su^pe_rbe& c[ae]li^tu_m se&de&s pe^te& 	X_^_X_^_X_^X	1.0
Humana temne. iam Styga et manes, ferox,	hu&ma_na^ te_mne& ja&m sty^ga& e&t ma&ne&s fe^ro&x 	X_^_X_^_X_^X	1.0
Fugisse credis? hic tibi ostendam inferos.	fu&gi_sse^ cre_di&s hi&c ti^bi& o_ste&nda&m i_nfe^ro&s 	X_^_X_^_X_^X	1.0
Reuocabo in alta conditam caligine,	re^vo^ca_bo& i^n a_lta& co_ndi^ta&m ca&li_gi^ne& 	^^_^_X_^_X_^X	1.0
Vltra nocentum exilia, discordem deam	u&ltra_ no^ce_ntu&m e&xi^li^a^ di_sco&rde&m de^a&m 	X_^_X^^^_X_^X	1.0
Quam munit ingens montis oppositi specus;	qva&m mu_ni^t i_nge&ns mo_nti^s o_ppo^si^ti& spe^cu&s 	X_^_X_^_^^_^X	0.79
Educam et imo Ditis e regno extraham	e&du_ca&m e^t i_mo& di_ti^s e_ re&gno& e_xtra^ha&m 	X_^_X_^_X_^X	1.0
Quidquid relictum est: ueniet inuisum Scelus	qvi&dqvi&d re^li_ctu&m e&st ve^ni^e^t i_nvi&su&m sce^lu&s 	X_^_X^^^_X_^X	1.0
Suumque lambens sanguinem Impietas ferox	su&u_mqve^ la_mbe&ns sa_ngvi^ne&m i_mpi^e^ta&s fe^ro&x 	X_^_X_^_^^_^X	1.0
Errorque et in se semper armatus Furor -	e&rro_rqve& e^t i&n se& se_mpe^r a_rma&tu&s fu^ro&r 	X_^_X_^_X_^X	1.0
Hoc hoc ministro noster utatur dolor.	ho&c ho&c mi^ni_stro& no_ste^r u_ta&tu&r do^lo&r 	X_^_X_^_X_^X	1.0
Incipite, famulae Ditis, ardentem citae	i&nci^pi^te^ fa^mu^l[ae] di_ti^s a_rde&nte&m ci^t[ae] 	X^^^^^X_^_X_^X	1.0
Concutite pinum et agmen horrendum anguibus	co&ncu^ti^te^ pi_nu&m e&t a_gme^n ho_rre&ndu&m a_ngvi^bu&s 	X^^^_X_^_X_^X	1.0
Megaera ducat atque luctifica manu	me&g[ae]ra^ du_ca&t a_tqve^ lu_cti^fi^ca_ ma^nu&	X_^_X_^_^^_^X	m
Vastam rogo flagrante corripiat trabem.	va&sta&m ro^go& fla&gra_nte^ co_rri^pi^a&t tra^be&m 	X_^_X_^_^^_^X	1.0
Hoc agite, poenas petite uiolatae Stygis;	ho&c a^gi^te^ p[oe]na&s pe^ti^te^ vi^o^la&t[ae] sty^gi&s 	X^^^_X^^^^^X_^X	1.0
Concutite pectus, acrior mentem excoquat	co&ncu^ti^te^ pe_ctu&s a_cri^o&r me&nte&m e_xco^qva&t 	X^^^_X_^_X_^X	1.0
Quam qui caminis ignis Aetnaeis furit.	qva&m qvi_ ca^mi_ni&s i_gni^s [ae]tn[ae]i&s fu^ri&t 	X_^_X_^_X_^X	0.91
Vt possit animum captus Alcides agi,	u&t po_ssi^t a^ni^mu&m ca_ptu^s a_lci&de_s a^gi& 	X_^^^X_^_X_^X	1.0
Magno furore percitus, nobis prius	ma&gno_ fu^ro_re& pe_rci^tu&s no&bi&s pri^u&s 	X_^_X_^_X_^X	1.0
Insaniendum est: Iuno, cur nondum furis?	i&nsa_ni^e_ndu&m e&st ju_no^ cu&r no&ndu&m fu^ri&s 	X_^_X_^_X_^X	0.47
Me me, sorores, mente deiectam mea	me& me_ so^ro_re&s me_nte^ d[ei]e&cta&m me^a& 	X_^_X_^_X_^X	1.0
Versate primam, facere si quicquam apparo	ve&rsa_te^ pri_ma&m fa^ce^re^ si& qvi&cqva&m a_ppa^ro& 	X_^_X^^^_X_^X	1.0
Dignum nouerca. uota mutentur mea:	di&gnu&m no^ve_rca& vo_ta^ mu_te&ntu&r me^a& 	X_^_X_^_X_^X	1.0
Natos reuersus uideat incolumes pater	na&to&s re^ve_rsu&s vi^de^a^t i_nco^lu^me&s pa^te&r 	X_^_X^^^_^^_^X	1.0
Manuque fortis redeat. inueni diem,	ma&nu_qve^ fo_rti&s re^de^a^t i_nve&ni_ di^e&m 	X_^_X^^^_X_^X	1.0
Inuisa quo nos Herculis uirtus iuuet.	i&nvi_sa^ qvo_ no&s he_rcu^li&s vi&rtu&s ju^ve&t 	X_^_X_^_X_^X	1.0
Me uicit? et se uincat et cupiat mori	me& vi_ci^t e&t se& vi_nca^t e&t cu^pi^a&t mo^ri& 	X_^_X_^_^^_^X	1.0
Ab inferis reuersus. hic prosit mihi	a&b i_nfe^ri_s re&ve_rsu^s hi&c pro&si&t mi^hi& 	X_^_X_^_X_^X	1.0
Ioue esse genitum. stabo et, ut certo exeant	jo&ve& e_sse^ ge^ni^tu&m sta_bo& e^t u&t ce&rto& e_xe^a&nt 	X_^^^X_^_X_^X	1.0
Emissa neruo tela, librabo manu,	e&mi_ssa^ ne_rvo& te_la^ li_bra&bo_ ma^nu& 	X_^_X_^_X_^X	1.0
Regam furentis arma, pugnanti Herculi	re&ga&m fu^re_nti&s a_rma^ pu_gna&nti& he_rcu^li& 	X_^_X_^_X_^X	1.0
Tandem fauebo - scelere perfecto licet	ta&nde&m fa^ve_bo& sce^le^re^ pe_rfe&cto_ li^ce&t 	X_^_X^^^_X_^X	1.0
Admittat illas genitor in caelum manus.	a&dmi_tta^t i_lla&s ge^ni^to^r i&n c[ae]lu&m ma^nu&s 	X_^_X^^^_X_^X	0.01
Mouenda iam sunt bella: clarescit dies	mo&ve_nda^ ja&m su&nt be_lla^ cla_re&sci_t di^e&s 	X_^_X_^_X_^X	1.0
Ortuque Titan lucidus croceo subit.	o&rtu_qve^ ti_ta&n lu_ci^du&s cro^ce^o_ su^bi&t 	X_^_X_^_^^_^X	1.0
O magne Olympi rector et mundi arbiter,	o& ma_gne& o^ly_mpi& re_cto^r e&t mu&ndi& a_rbi^te&r 	X_^_X_^_X_^X	1.0
Iam statue tandem grauibus aerumnis modum	ja&m sta^tu^e^ ta_nde&m gra^vi^bu^s [ae]ru&mni_s mo^du&m 	X^^^_X^^^_X_^X	1.0
Finemque cladi. nulla lux umquam mihi	fi&ne_mqve^ cla_di& nu_lla^ lu&x u&mqva&m mi^hi& 	X_^_X_^_X_^X	1.0
Secura fulsit: finis alterius mali	se&cu_ra^ fu_lsi&t fi_ni^s a_lte^ri^u&s ma^li& 	X_^_X_^_^^_^X	0.63
Gradus est futuri. protinus reduci nouus	gra^du^s e&st fu^tu_ri& pro_ti^nu&s re^du^ci_ no^vu&s 	^^_^_X_^_^^_^X	0.06
Paratur hostis; antequam laetam domum	pa&ra_tu^r ho_sti&s a_nte^qva_m l[ae]ta&m do^mu&m 	X_^_X_^_X_^X	1.0
Contingat, aliud iussus ad bellum meat;	co&nti_nga^t a^li^u&d ju_ssu^s a&d be&llu&m me^a&t 	X_^^^X_^_X_^X	1.0
Nec ulla requies tempus aut ullum uacat,	ne&c u_lla^ re^qvi^e&s te_mpu^s [au]t u&llu&m va^ca&t 	X_^^^X_^_X_^X	1.0
Nisi dum iubetur. sequitur a primo statim	ni^si^ du&m ju^be_tu&r se^qvi^tu^r a& pri&mo& sta^ti&m 	^^_^_X^^^_X_^X	0.97
Infesta Iuno: numquid immunis fuit	i&nfe_sta^ ju_no& nu_mqvi^d i_mmu&ni&s fu^i&t 	X_^_X_^_X_^X	1.0
Infantis aetas? monstra superauit prius	i&nfa_nti^s [ae]ta&s mo_nstra^ su^pe^r[au]i&t pri^u&s 	X_^_X_^^^X_^X	1.0
Quam nosse posset. Gemina cristati caput	qva&m no_sse^ po_sse&t ge^mi^na^ cri_sta&ti_ ca^pu&t 	X_^_X^^^_X_^X	1.0
Angues ferebant ora, quos contra obuius	a&ngve&s fe^re_ba&nt o_ra^ qvo&s co&ntra& o_bvi^u&s 	X_^_X_^_X_^X	1.0
Reptauit infans igneos serpentium	re&pt[au]i^t i_nfa&ns i_gne^o&s se&rpe_nti^u&m 	X_^_X_^_X_^X	1.0
Oculos remisso pectore ac placido intuens;	o^cu^lo&s re^mi_sso& pe_cto^re& a&c pla^ci^do& i_ntu^e&ns 	^^_^_X_^_^^_^X	1.0
Artos serenis uultibus nodos tulit,	a&rto&s se^re_ni&s vu_lti^bu&s no&do&s tu^li&t 	X_^_X_^_X_^X	1.0
Et tumida tenera guttura elidens manu	e&t tu^mi^da^ te^ne^ra& gu_ttu^ra& e_li&de_ns ma^nu& 	X^^^^^X_^_X_^X	1.0
Prolusit hydrae. Maenali pernix fera,	pro&lu_si^t hy_dr[ae] m[ae]na^li_ pe&rni&x fe^ra& 	X_^_X_^_X_^X	1.0
Multo decorum praeferens auro caput,	mu&lto_ de^co_ru&m pr[ae]fe^re_ns [au]ro_ ca^pu&t 	X_^_X_^_X_^X	1.0
Deprensa cursu; maximus Nemeae timor	de&pre_nsa^ cu_rsu& ma_xi^mu&s ne^me^[ae] ti^mo&r 	X_^_X_^_^^_^X	1.0
Pressus lacertis gemuit Herculeis leo.	pre&ssu&s la^ce_rti&s ge^mu^i^t he_rcu^le^i&s le^o& 	X_^_X^^^_^^_^X	1.0
Quid stabula memorem dira Bistonii gregis	qvi&d sta^bu^la^ me^mo^re&m di_ra^ bi_sto^ni^i& gre^gi&s 	X^^^^^X_^_^^_^X	1.0
Suisque regem pabulum armentis datum,	su&i_sqve^ re_ge&m pa_bu^lu&m a_rme&nti&s da^tu&m 	X_^_X_^_X_^X	1.0
Solitumque densis hispidum Erymanthi iugis	so^li^tu_mqve^ de_nsi&s hi_spi^du&m e^ry^ma&nthi_ ju^gi&s 	^^_^_X_^^^X_^X	1.0
Arcadia quatere nemora Maenalium suem,	a&rca^di^a^ qva^te^re& ne^mo^ra^ m[ae]na^li^u&m su^e&m	X^^^^^X^^^_^^_^X	m
Taurumque centum non leuem populis metum?	t[au]ru_mqve^ ce_ntu&m no&n le^ve&m po^pu^li&s me^tu&m 	X_^_X_^_^^_^X	0.93
Inter remotos gentis Hesperiae greges	i&nte&r re^mo_to&s ge_nti^s he_spe^ri^[ae] gre^ge&s 	X_^_X_^_^^_^X	0.7
Pastor triformis litoris Tartesii	pa&sto&r tri^fo_rmi&s li_to^ri&s ta&rte_si^i& 	X_^_X_^_X_^X	1.0
Peremptus, acta est praeda ab occasu ultimo:	pe&re_mptu^s a_cta& e&st pr[ae]da& a^b o_cca&su& u_lti^mo& 	X_^_X_^_X_^X	1.0
Notum Cithaeron pauit Oceano pecus.	no&tu&m ci^th[ae]ro&n p[au]i^t o_ce^a^no_ pe^cu&s 	X_^_X_^_^^_^X	1.0
Penetrare iussus solis aestiui plagas	pe^ne^tra_re^ ju_ssu&s so_li^s [ae]sti&vi& pla^ga&s 	^^_^_X_^_X_^X	0.64
Et adusta medius regna quae torret dies	e^t a^du_sta^ me^di^u&s re_gna^ qv[ae] to&rre&t di^e&s 	^^_^^^X_^_X_^X	1.0
Vtrimque montes soluit ac rupto obice	u&tri_mqve^ mo_nte&s so_lvi^t a&c ru&pto& o_bi^ce& 	X_^_X_^_X_^X	1.0
Latam ruenti fecit Oceano uiam.	la&ta&m ru^e_nti& fe_ci^t o_ce^a^no_ vi^a&m 	X_^_X_^_^^_^X	1.0
Post haec adortus nemoris opulenti domos	po&st h[ae]c a^do_rtu&s ne^mo^ri^s o^pu^le&nti_ do^mo&s 	X_^_X^^^^^X_^X	1.0
Aurifera uigilis spolia serpentis tulit.	[au]ri^fe^ra^ vi^gi^li&s spo^li^a^ se_rpe&nti&s tu^li&t 	X^^^^^X^^^_X_^X	1.0
Quid? saeua Lernae monstra, numerosum malum,	qvi&d s[ae]va^ le_rn[ae] mo_nstra^ nu^me^ro&su&m ma^lu&m 	X_^_X_^^^X_^X	0.72
Non igne demum uicit et docuit mori,	no&n i_gne^ de_mu&m vi_ci^t e&t do^cu^i&t mo^ri& 	X_^_X_^_^^_^X	1.0
Solitasque pinnis condere obductis diem	so^li^ta_sqve^ pi_nni&s co_nde^re& o_bdu&cti&s di^e&m 	^^_^_X_^_X_^X	0.94
Petit ab ipsis nubibus Stymphalidas?	pe&ti_t a^b i_psi&s nu_bi^bu&s sty&mpha_li^da&s 	X_^_X_^_X_^X	0.06
Non uicit illum caelibis semper tori	no&n vi_ci^t i_llu&m c[ae]li^bi_s se&mpe&r to^ri& 	X_^_X_^_X_^X	1.0
Regina gentis uidua Thermodontiae,	re&gi_na^ ge_nti&s vi^du^a^ the_rmo&do_nti^[ae]	X_^_X^^^_X_^X	m
Nec ad omne clarum facinus audaces manus	ne^c a^d o_mne^ cla_ru&m fa^ci^nu^s [au]da&ce&s ma^nu&s 	^^_^_X^^^_X_^X	1.0
Stabuli fugauit turpis Augei labor.	sta^bu^li_ fu^ga_vi&t tu_rpi^s [au]ge&i_ la^bo&r.	^^_^_X_^_X_^X	m
Quid ista prosunt? orbe defenso caret.	qvi&d i_sta^ pro_su&nt o_rbe^ de_fe&nso_ ca^re&t 	X_^_X_^_X_^X	1.0
Sensere terrae pacis auctorem suae	se&nse_re^ te_rr[ae] pa_ci^s [au]cto&re&m su^[ae] 	X_^_X_^_X_^X	1.0
Abesse terris: prosperum ac felix scelus	a&be_sse^ te_rri&s pro_spe^ru&m a&c fe&li&x sce^lu&s 	X_^_X_^_X_^X	1.0
Virtus uocatur; sontibus parent boni,	vi&rtu&s vo^ca_tu&r so_nti^bu&s pa&re&nt bo^ni& 	X_^_X_^_X_^X	1.0
Ius est in armis, opprimit leges timor.	ju&s e&st i^n a_rmi&s o_ppri^mi&t le&ge&s ti^mo&r 	X_^_X_^_X_^X	1.0
Ante ora uidi nostra truculenta manu	a&nte& o_ra^ vi_di& no_stra^ tru^cu^le&nta_ ma^nu& 	X_^_X_^^^X_^X	1.0
Gnatos paterni cadere regni uindices	gna&to_s pa^te_rni& ca^de^re^ re_gni& vi_ndi^ce&s 	X_^_X^^^_X_^X	1.0
Ipsumque, Cadmi nobilis stirpem ultimam,	i&psu_mqve^ ca_dmi& no_bi^li&s sti&rpe&m u_lti^ma&m 	X_^_X_^_X_^X	1.0
Occidere, uidi regium capiti decus	o&cci^de^re^ vi_di& re_gi^u&m ca^pi^ti_ de^cu&s 	X^^^_X_^_^^_^X	1.0
Cum capite raptum - quis satis Thebas fleat?	cu&m ca^pi^te^ ra_ptu&m qvi&s sa^ti&s the&ba&s fle^a&t 	X^^^_X_^_X_^X	1.0
Ferax deorum terra, quem dominum tremit!	fe&ra&x de^o_ru&m te_rra^ qve&m do^mi^nu&m tre^mi&t 	X_^_X_^_^^_^X	1.0
E cuius aruis eque fecundo sinu	e& cu_ju^s a_rvi&s e_qve^ fe_cu&ndo_ si^nu& 	X_^_X_^_X_^X	1.0
Stricto iuuentus orta cum ferro stetit	stri&cto_ ju^ve_ntu&s o_rta^ cu&m fe&rro& ste^ti&t 	X_^_X_^_X_^X	1.0
Cuiusque muros natus Amphion Ioue	cu&ju_sqve^ mu_ro&s na_tu^s a_mphi&o&n jo^ve& 	X_^_X_^_X_^X	1.0
Struxit canoro saxa modulatu trahens,	stru&xi&t ca^no_ro& sa_xa^ mo^du^la&tu& tra^he&ns 	X_^_X_^^^X_^X	1.0
In cuius urbem non semel diuum parens	i&n cu_ju^s u_rbe&m no&n se^me&l di&vu&m pa^re&ns 	X_^_X_^_X_^X	0.97
Caelo relicto uenit, haec quae caelites	c[ae]lo_ re^li_cto& ve_ni^t h[ae]c qv[ae] c[ae]li^te&s 	X_^_X_^_X_^X	0.43
Recepit et quae fecit et - fas sit loqui -	re&ce_pi^t e&t qv[ae] fe_ci^t e&t fa&s si&t lo^qvi& 	X_^_X_^_X_^X	1.0
Fortasse faciet, sordido premitur iugo.	fo&rta_sse^ fa^ci^e&t so_rdi^do& pre^mi^tu&r ju^go&	X_^^^X_^_^^_^X	m
Cadmea proles atque Ophionium genus,	ca&dme_a^ pro_le&s a_tqve& o^phi_o^ni^u&m ge^nu&s	X_^_X_^_^^_^X	m
Quo reccidistis? tremitis ignauum exulem,	qvo& re_cci^di_sti&s tre^mi^ti^s i_gn[au]u&m e_xu^le&m 	X_^_X^^^_X_^X	1.0
Suis carentem finibus, nostris grauem.	su&i&s ca^re_nte&m fi_ni^bu&s no&stri&s gra^ve&m 	X_^_X_^_X_^X	1.0
Qui scelera terra quique persequitur mari	qvi& sce^le^ra^ te_rra& qvi_qve^ pe_rse^qvi^tu&r ma^ri& 	X^^^_X_^_^^_^X	1.0
Ac saeua iusta sceptra confregit manu	a&c s[ae]va^ ju_sta& sce_ptra^ co_nfre&gi&t ma^nu& 	X_^_X_^_X_^X	1.0
Nunc seruit absens fertque quae fieri uetat,	nu&nc se_rvi^t a_bse&ns fe_rtqve^ qv[ae] fi^e^ri_ ve^ta&t 	X_^_X_^_^^_^X	1.0
Tenetque Thebas exul Herculeas Lycus. -	te&ne_tqve^ the_ba&s e_xu^l he_rcu^le^a&s ly^cu&s 	X_^_X_^_^^_^X	1.0
Sed non tenebit. aderit et poenas petet	se&d no&n te^ne_bi&t a^de^ri^t e&t p[oe]na&s pe^te&t 	X_^_X^^^_X_^X	1.0
Subitusque ad astra emerget; inueniet uiam	su^bi^tu_sqve& a^d a_stra& e&me_rge^t i_nve^ni^e&t vi^a&m 	^^_^_X_^_^^_^X	1.0
Aut faciet. Adsis sospes et remees tuis	[au]t fa^ci^e^t a_dsi&s so_spe^s e&t re^me^e&s tu^i&s	X^^^_X_^_^^_^X	m
Tandemque uenias uictor ad uictam domum.	ta&nde_mqve^ ve^ni^a&s vi_cto^r a&d vi&cta&m do^mu&m 	X_^^^X_^_X_^X	1.0
Emerge, coniunx, atque dispulsas manu	e&me_rge^ co_nju&nx a_tqve^ di_spu&lsa&s ma^nu& 	X_^_X_^_X_^X	1.0
Abrumpe tenebras; nulla si retro uia	a&bru_mpe^ te^ne^bra&s nu_lla^ si_ re&tro_ vi^a& 	X_^^^X_^_X_^X	0.57
Iterque clusum est, orbe diducto redi	i&te_rqve^ clu_su&m e&st o_rbe^ di_du&cto_ re^di& 	X_^_X_^_X_^X	1.0
Et quidquid atra nocte possessum latet	e&t qvi_dqvi^d a_tra& no_cte^ po_sse&ssu&m la^te&t 	X_^_X_^_X_^X	1.0
Emitte tecum. dirutis qualis iugis	e&mi_tte^ te_cu&m di_ru^ti&s qva&li&s ju^gi&s 	X_^_X_^_X_^X	1.0
Praeceps citato flumini quaerens iter	pr[ae]ce&ps ci^ta_to& flu_mi^ni_ qv[ae]re&ns i^te&r 	X_^_X_^_X_^X	1.0
Quondam stetisti, scissa cum uasto impetu	qvo&nda&m ste^ti_sti& sci_ssa^ cu&m va&sto& i_mpe^tu& 	X_^_X_^_X_^X	1.0
Patuere Tempe, pectore impulsus tuo	pa^tu^e_re^ te_mpe& pe_cto^re& i_mpu&lsu&s tu^o& 	^^_^_X_^_X_^X	1.0
Huc mons et illuc cecidit, et rupto aggere	hu&c mo&ns e^t i_llu&c ce^ci^di^t e&t ru&pto& a_gge^re& 	X_^_X^^^_X_^X	0.97
Noua cucurrit Thessalus torrens uia:	no&va_ cu^cu_rri&t the_ssa^lu&s to&rre&ns vi^a& 	X_^_X_^_X_^X	1.0
Talis, parentes liberos patriam petens,	ta&li&s pa^re_nte&s li_be^ro_s pa^tri^a&m pe^te&ns 	X_^_X_^_^^_^X	1.0
Erumpe rerum terminos tecum efferens,	e&ru_mpe^ re_ru&m te_rmi^no&s te&cu&m e_ffe^re&ns 	X_^_X_^_X_^X	1.0
Et quidquid auida tot per annorum gradus	e&t qvi_dqvi^d a^vi^da& to&t pe^r a_nno&ru&m gra^du&s 	X_^^^X_^_X_^X	1.0
Abscondit aetas redde et oblitos sui	a&bsco_ndi^t [ae]ta&s re_dde& e^t o_bli&to&s su^i& 	X_^_X_^_X_^X	1.0
Lucisque pauidos ante te populos age:	lu&ci_sqve^ pa^vi^do&s a_nte^ te_ po^pu^lo_s a^ge& 	X_^^^X_^_^^_^X	1.0
Indigna te sunt spolia, si tantum refers	i&ndi_gna^ te_ su&nt spo^li^a^ si_ ta&ntu&m re^fe&rs 	X_^_X^^^_X_^X	1.0
Quantum imperatum est. Magna sed nimium loquor	qva&ntu&m i_mpe^ra_tu&m e&st ma_gna^ se&d ni^mi^u&m lo^qvo&r 	X_^_X_^_^^_^X	1.0
Ignara nostrae sortis. unde illum mihi	i&gna_ra^ no_str[ae] so_rti^s u_nde& i&llu&m mi^hi& 	X_^_X_^_X_^X	0.8
Quo te tuamque dexteram amplectar diem	qvo& te_ tu^a_mqve& de_xte^ra&m a_mple&cta&r di^e&m 	X_^_X_^_X_^X	1.0
Reditusque lentos nec mei memores querar?	re^di^tu_sqve^ le_nto&s ne&c me^i_ me^mo^re&s qve^ra&r 	^^_^_X_^_^^_^X	1.0
Tum tibi, deorum ductor, indomiti ferent	tu&m ti^bi^ de^o_ru&m du_cto^r i_ndo^mi^ti_ fe^re&nt 	X^^^_X_^_^^_^X	0.85
Centena tauri colla; tibi, frugum potens,	ce&nte_na^ t[au]ri& co_lla^ ti^bi^ fru&gu&m po^te&ns 	X_^_X_^^^X_^X	0.85
Secreta reddam sacra; tibi muta fide	se&cre_ta^ re_dda&m sa_cra^ ti^bi^ mu&ta_ fi^de&	X_^_X_^^^X_^X	m
Longas Eleusin tacita iactabit faces.	lo&nga_s e^l[eu]si&n ta^ci^ta^ ja_cta&bi&t fa^ce&s 	X_^_X^^^_X_^X	0.98
Tum restitutas fratribus rebor meis	tu&m re_sti^tu_ta&s fra_tri^bu&s re&bo&r me^i&s 	X_^_X_^_X_^X	1.0
Animas et ipsum regna moderantem sua	a^ni^ma_s e^t i_psu&m re_gna^ mo^de^ra&nte&m su^a& 	^^_^_X_^^^X_^X	1.0
Florere patrem. si qua te maior tenet	flo&re_re^ pa_tre&m si& qva^ te_ ma&jo&r te^ne&t 	X_^_X_^_X_^X	0.29
Clausum potestas, sequimur: aut omnis tuo	cl[au]su&m po^te_sta&s se^qvi^mu^r [au]t o&mni&s tu^o& 	X_^_X^^^_X_^X	1.0
Defende reditu sospes aut omnes trahe. -	de&fe_nde^ re^di^tu& so_spe^s [au]t o&mne&s tra^he& 	X_^^^X_^_X_^X	1.0
Trahes nec ullus eriget fractos deus.	tra&he&s ne^c u_llu&s e_ri^ge&t fra&cto&s de^u&s 	X_^_X_^_X_^X	1.0
O socia nostri sanguinis, casta fide	o& so^ci^a^ no_stri& sa_ngvi^ni&s ca&sta_ fi^de& 	X^^^_X_^_X_^X	0.97
Seruans torum gnatosque magnanimi Herculis,	se&rva&ns to^ru&m gna&to_sqve^ ma_gna^ni^mi& he_rcu^li&s 	X_^_X_^_^^_^X	1.0
Meliora mente concipe atque animum excita.	me^li^o_ra^ me_nte& co_nci^pe& a_tqve& a^ni^mu&m e_xci^ta& 	^^_^_X_^_^^_^X	0.67
Aderit profecto, qualis ex omni solet	a^de^ri&t pro^fe_cto& qva_li^s e&x o&mni_ so^le&t 	^^_^_X_^_X_^X	1.0
Labore, maior. Quod nimis miseri uolunt,	la&bo_re^ ma_jo&r qvo&d ni^mi&s mi^se^ri_ vo^lu&nt 	X_^_X_^_^^_^X	1.0
Hoc facile credunt. Immo quod metuunt nimis	ho&c fa^ci^le^ cre_du&nt i_mmo^ qvo&d me^tu^u&nt ni^mi&s 	X^^^_X_^_^^_^X	1.0
Numquam moueri posse nec tolli putant:	nu&mqva&m mo^ve_ri& po_sse^ ne&c to&lli_ pu^ta&nt 	X_^_X_^_X_^X	1.0
Prona est timoris semper in peius fides.	pro&na& e&st ti^mo_ri&s se_mpe^r i&n p[ei]u&s fi^de&s 	X_^_X_^_X_^X	1.0
Demersus ac defossus et toto insuper	de&me_rsu^s a&c de&fo_ssu^s e&t to&to& i_nsu^pe&r 	X_^_X_^_X_^X	1.0
Oppressus orbe quam uiam ad superos habet?	o&ppre_ssu^s o_rbe& qva&m vi^a&m a&d su^pe^ro_s ha^be&t 	X_^_X_^_^^_^X	1.0
Quam tunc habebat cum per arentem plagam	qva&m tu&nc ha^be_ba&t cu&m pe^r a_re&nte&m pla^ga&m 	X_^_X_^_X_^X	0.5
Et fluctuantes more turbati maris	e&t flu_ctu^a_nte&s mo_re^ tu_rba&ti_ ma^ri&s 	X_^_X_^_X_^X	1.0
Adit harenas bisque discedens fretum	a&di_t ha^re_na&s bi_sqve^ di_sce&de&ns fre^tu&m 	X_^_X_^_X_^X	0.16
Et bis recurrens, cumque deserta rate	e&t bi&s re^cu_rre&ns cu_mqve^ de_se&rta_ ra^te& 	X_^_X_^_X_^X	1.0
Deprensus haesit Syrtium breuibus uadis	de&pre_nsu^s h[ae]si&t sy_rti^u&m bre^vi^bu&s va^di&s	X_^_X_^_^^_^X	m
Et puppe fixa maria superauit pedes.	e&t pu_ppe^ fi_xa& ma^ri^a^ su^pe^r[au]i&t pe^de&s 	X_^_X^^^^^X_^X	1.0
Iniqua raro maximis uirtutibus	i&ni_qva^ ra_ro& ma_xi^mi&s vi&rtu_ti^bu&s 	X_^_X_^_X_^X	1.0
Fortuna parcit; nemo se tuto diu	fo&rtu_na^ pa_rci&t ne_mo^ se_ tu&to_ di^u& 	X_^_X_^_X_^X	0.5
Periculis offerre tam crebris potest:	pe&ri_cu^li_s o&ffe_rre^ ta&m cre&bri&s po^te&st 	X_^_X_^_X_^X	1.0
Quem saepe transit casus, aliquando inuenit.	qve&m s[ae]pe^ tra_nsi&t ca_su^s a^li^qva&ndo& i_nve^ni&t 	X_^_X_^^^X_^X	0.26
Sed ecce saeuus ac minas uultu gerens	se&d e_cce^ s[ae]vu&s a&c mi^na&s vu&ltu_ ge^re&ns 	X_^_X_^_X_^X	1.0
Et qualis animo est talis incessu uenit	e&t qva_li^s a^ni^mo& e&st ta_li^s i_nce&ssu_ ve^ni&t 	X_^^^X_^_X_^X	0.5
Aliena dextra sceptra concutiens Lycus.	a^li^e_na^ de_xtra& sce_ptra^ co_ncu^ti^e&ns ly^cu&s 	^^_^_X_^_^^_^X	1.0
Vrbis regens opulenta Thebanae loca	u&rbi&s re^ge&ns o^pu^le_nta^ the_ba&n[ae] lo^ca& 	X_^_^^_^_X_^X	1.0
Et omne quidquid uberis cingit soli	e&t o_mne^ qvi_dqvi&d u_be^ri&s ci&ngi&t so^li& 	X_^_X_^_X_^X	0.24
Obliqua Phocis, quidquid Ismenos rigat,	o&bli_qva^ pho_ci&s qvi_dqvi^d i_sme&no&s ri^ga&t 	X_^_X_^_X_^X	1.0
Quidquid Cithaeron uertice excelso uidet	qvi&dqvi&d ci^th[ae]ro&n ve_rti^ce& e_xce&lso_ vi^de&t 	X_^_X_^_X_^X	1.0
Et bina findens Isthmos exilis freta,	e&t bi_na^ fi_nde&ns i_sthmo^s e_xi&li&s fre^ta& 	X_^_X_^_X_^X	0.94
Non uetera patriae iura possideo domus	no&n ve^te^ra^ pa^tri^[ae] ju_ra^ po_ssi^de^o_ do^mu&s	X^^^^^X_^_^^_^X	m
Ignauus heres; nobiles non sunt mihi	i&gn[au]u^s he_re&s no_bi^le&s no&n su&nt mi^hi& 	X_^_X_^_X_^X	1.0
Aui nec altis inclitum titulis genus,	a&vi_ ne^c a_lti&s i_ncli^tu&m ti^tu^li&s ge^nu&s 	X_^_X_^_^^_^X	1.0
Sed clara uirtus: qui genus iactat suum,	se&d cla_ra^ vi_rtu&s qvi_ ge^nu&s ja&cta&t su^u&m 	X_^_X_^_X_^X	1.0
Aliena laudat. rapta sed trepida manu	a^li^e_na^ l[au]da&t ra_pta^ se&d tre^pi^da_ ma^nu&	^^_^_X_^_^^_^X	m
Sceptra optinentur; omnis in ferro est salus:	sce&ptra& o_pti^ne_ntu&r o_mni^s i&n fe&rro& e&st sa^lu&s 	X_^_X_^_X_^X	0.87
Quod ciuibus tenere te inuitis scias,	qvo&d ci_vi^bu&s te&ne_re^ te& i_nvi&ti&s sci^a&s 	X_^_X_^_X_^X	1.0
Strictus tuetur ensis. alieno in loco	stri&ctu&s tu^e_tu&r e_nsi^s a^li^e&no& i&n lo^co& 	X_^_X_^^^X_^X	0.95
Haut stabile regnum est; una sed nostras potest	h[au]t sta^bi^le^ re_gnu&m e&st u_na^ se&d no&stra&s po^te&st 	X^^^_X_^_X_^X	1.0
Fundare uires iuncta regali face	fu&nda_re^ vi_re&s ju_ncta^ re_ga&li_ fa^ce& 	X_^_X_^_X_^X	1.0
Thalamisque Megara: ducet e genere inclito	tha^la^mi_sqve^ me^ga^ra& du_ce^t e_ ge^ne^re& i_ncli^to&	^^_^^^X_^_^^_^X	m
Nouitas colorem nostra. non equidem reor	no^vi^ta&s co^lo_re&m no_stra^ no_n e^qvi^de&m re^o&r 	^^_^_X_^_^^_^X	1.0
Fore ut recuset ac meos spernat toros;	fo&re& u&t re^cu_se&t a&c me^o&s spe&rna&t to^ro&s 	X_^_X_^_X_^X	1.0
Quod si impotenti pertinax animo abnuet,	qvo&d si& i_mpo^te_nti& pe_rti^na_x a^ni^mo& a_bnu^e&t 	X_^_X_^_^^_^X	1.0
Stat tollere omnem penitus Herculeam domum.	sta&t to_lle^re& o_mne&m pe^ni^tu^s he_rcu^le^a&m do^mu&m 	X_^_X^^^_^^_^X	1.0
Inuidia factum ac sermo popularis premet?	i_nui^di^a^ fa_ctu&m a&c se_rmo^ po^pu^la&ri&s pre^me&t? 	X^^^_X_^^^X_^X	m
Ars prima regni est posse in inuidia pati.	a&rs pri_ma^ re_gni& e&st po_sse& i^n i_nvi^di^a_ pa^ti&	X_^_X_^_^^_^X	m
Temptemus igitur, fors dedit nobis locum;	te&mpte_mu^s i^gi^tu&r fo&rs de^di&t no&bi&s lo^cu&m 	X_^^^X_^_X_^X	1.0
Namque ipsa, tristi uestis obtentu caput	na&mqve& i_psa^ tri_sti& ve_sti^s o_bte&ntu_ ca^pu&t 	X_^_X_^_X_^X	0.57
Velata, iuxta praesides adstat deos,	ve&la_ta^ ju_xta& pr[ae]si^de_s a&dsta&t de^o&s 	X_^_X_^_X_^X	1.0
Laterique adhaeret uerus Alcidae sator.	la^te^ri_qve& a^dh[ae]re&t ve_ru^s a_lci&d[ae] sa^to&r 	^^_^_X_^_X_^X	1.0
Quidnam iste, nostri generis exitium ac lues,	qui_dna&m i_ste^, no_stri_ ge^ne^ri^s e_xi^ti^u&m a&c lu^e&s, 	X_^_X^^^_^^_^X	m
Noui parat? quid temptat? O clarum trahens	no&vi_ pa^ra&t qvi&d te_mpta^t o& cla&ru&m tra^he&ns 	X_^_X_^_X_^X	1.0
A stirpe nomen regia, facilis mea	a& sti_rpe^ no_me&n re_gi^a_ fa^ci^li&s me^a&	X_^_X_^_^^_^X	m
Parumper aure uerba patienti excipe.	pa&ru_mpe^r [au]re& ve_rba^ pa^ti^e&nti& e_xci^pe& 	X_^_X_^^^X_^X	1.0
Si aeterna semper odia mortales gerant,	si& [ae]te_rna^ se_mpe&r o^di^a^ mo_rta&le&s ge^ra&nt 	X_^_X^^^_X_^X	1.0
Nec coeptus umquam cedat ex animis furor,	ne&c c[oe]ptu^s u_mqva&m ce_da^t e&x a^ni^mi&s fu^ro&r 	X_^_X_^_^^_^X	1.0
Sed arma felix teneat, infelix paret,	se&d a_rma^ fe_li&x te^ne^a^t i_nfe&li&x pa^re&t 	X_^_X^^^_X_^X	0.46
Nihil relinquent bella; tum uastis ager	ni&hi&l re^li_nqve&nt be_lla^ tu&m va&sti_s a^ge&r 	X_^_X_^_X_^X	1.0
Squalebit aruis, subdita tectis face	sqva&le_bi^t a_rvi&s su_bdi^ta_ te&cti&s fa^ce& 	X_^_X_^_X_^X	1.0
Altus sepultas obruet gentes cinis.	a&ltu&s se^pu_lta&s o_bru^e&t ge&nte&s ci^ni&s 	X_^_X_^_X_^X	1.0
Pacem reduci uelle uictori expedit,	pa&ce&m re^du_ci&& ue_lle^ ui_cto&ri& e_xpe^di&t, 	X_^_X_^_X_^X	m
Victo necesse est - particeps regno ueni;	vi&cto_ ne^ce_sse& e&st pa_rti^ce_ps re&gno_ ve^ni& 	X_^_X_^_X_^X	0.48
Sociemur animis; pignus hoc fidei cape:	so^ci^e_mu^r a^ni^mi&s pi_gnu^s ho&c fi^de^i_ ca^pe&	^^_^^^X_^_^^_^X	m
Continge dextram. quid truci uultu siles?	co&nti_nge^ de_xtra&m qvi&d tru^ci_ vu&ltu_ si^le&s 	X_^_X_^_X_^X	1.0
Egone ut parentis sanguine aspersam manum	e^go^ne& u&t pa^re_nti&s sa_ngvi^ne& a_spe&rsa_m ma^nu&m 	^^_^_X_^_X_^X	1.0
Fratrumque gemina caede contingam? prius	fra&tru_mqve^ ge^mi^na& c[ae]de^ co_nti&nga&m pri^u&s 	X_^^^X_^_X_^X	1.0
Extinguet ortus, referet occasus diem,	e&xti_ngve^t o_rtu&s re^fe^re^t o_cca&su&s di^e&m 	X_^_X^^^_X_^X	1.0
Pax ante fida niuibus et flammis erit	pa&x a_nte^ fi_da& ni^vi^bu^s e&t fla&mmi_s e^ri&t 	X_^_X^^^_X_^X	1.0
Et Scylla Siculum iunget Ausonio latus,	e&t scy_lla^ si^cu^lu&m ju_nge^t [au]so^ni^o_ la^tu&s 	X_^^^X_^_^^_^X	0.98
Priusque multo uicibus alternis fugax	pri&u_sqve^ mu_lto& vi^ci^bu^s a_lte&rni&s fu^ga&x 	X_^_X^^^_X_^X	1.0
Euripus unda stabit Euboica piger.	[eu]ri_pu^s u_nda& sta_bi^t [eu]bo&i^ca^ pi^ge&r	X_^_X_^_X^^^X	m
Patrem abstulisti, regna, germanos, larem	pa&tre&m a_bstu^li_sti& re_gna^ ge_rma&no&s la^re&m 	X_^_X_^_X_^X	1.0
Patrium - quid ultra est? una res superest mihi	pa^tri^u&m qvi^d u_ltra& e&st u_na^ re&s su^pe^re&st mi^hi& 	^^_^_X_^_^^_^X	1.0
Fratre ac parente carior, regno ac lare:	fra&tre& a&c pa^re_nte& ca_ri^o&r re&gno& a&c la^re& 	X_^_X_^_X_^X	1.0
Odium tui, quod esse cum populo mihi	o^di^u&m tu^i& qvo&d e_sse^ cu&m po^pu^lo_ mi^hi& 	^^_^_X_^_^^_^X	1.0
Commune doleo: pars quota ex isto mea est?	co&mmu_ne^ do^le^o& pa&rs qvo^ta& e&x i&sto_ me^a& e&st 	X_^^^X_^_X_^X	1.0
Dominare tumidus, spiritus altos gere:	do^mi^na_re^ tu^mi^du&s, spi_ri^tu_s a_lto&s ge^re&: 	^^_^^^X_^_X_^X	m
Sequitur superbos ultor a tergo deus.	se^qvi^tu&r su^pe_rbo&s u_lto^r a_ te&rgo_ de^u&s 	^^_^_X_^_X_^X	1.0
Thebana noui regna: quid matres loquar	the&ba_na^ no_vi& re_gna^ qvi&d ma&tre&s lo^qva&r 	X_^_X_^_X_^X	0.36
Passas et ausas scelera? quid geminum nefas	pa&ssa_s e^t [au]sa&s sce^le^ra^ qvi&d ge^mi^nu&m ne^fa&s 	X_^_X^^^_^^_^X	1.0
Mixtumque nomen coniugis gnati patris?	mi&xtu_mqve^ no_me&n co_nju^gi&s gna&ti_ pa^tri&s 	X_^_X_^_X_^X	0.55
Quid bina fratrum castra? quid totidem rogos?	qvi&d bi_na^ fra_tru&m ca_stra^ qvi&d to^ti^de&m ro^go&s 	X_^_X_^_^^_^X	1.0
Riget superbo Tantalis luctu parens	ri&ge&t su^pe_rbo& ta_nta^li&s lu&ctu_ pa^re&ns 	X_^_X_^_X_^X	0.97
Maestusque Phrygio manat in Sipylo lapis.	m[ae]stu_sqve^ phry^gi^o& ma_na^t i&n si^py^lo_ la^pi&s	X_^^^X_^_^^_^X	m
Quin ipse toruum subrigens crista caput	qvi&n i_pse^ to_rvu&m su_bri^ge_ns cri&sta_ ca^pu&t 	X_^_X_^_X_^X	1.0
Illyrica Cadmus regna permensus fuga	i&lly^ri^ca^ ca_dmu&s re_gna^ pe_rme&nsu&s fu^ga& 	X^^^_X_^_X_^X	1.0
Longas reliquit corporis tracti notas.	lo&nga&s re^li_qvi&t co_rpo^ri&s tra&cti_ no^ta&s 	X_^_X_^_X_^X	0.69
Haec te manent exempla: dominare ut libet,	h[ae]c te_ ma^ne&nt e&xe_mpla^ do^mi^na&re& u&t li^be&t 	X_^_X_^^^X_^X	0.97
Dum solita regni fata te nostri uocent.	du&m so^li^ta^ re_gni& fa_ta^ te_ no&stri_ vo^ce&nt 	X^^^_X_^_X_^X	1.0
Agedum efferatas rabida uoces amoue	a^ge^du&m e_ffe^ra_ta&s ra^bi^da^ vo_ce&s a_mo^ve& 	^^_^_X^^^_X_^X	0.99
Et disce regum imperia ab Alcide pati.	e&t di_sce^ re_gu&m i&mpe^ri^a& a^b a_lci&de_ pa^ti& 	X_^_X^^^_X_^X	1.0
Ego rapta quamuis sceptra uictrici geram	e^go^ ra_pta^ qva_mvi&s sce_ptra^ vi_ctri&ci_ ge^ra&m 	^^_^_X_^_X_^X	1.0
Dextra regamque cuncta sine legum metu	de&xtra_ re^ga_mqve& cu_ncta^ si^ne^ le&gu&m me^tu& 	X_^_X_^^^X_^X	1.0
Quas arma uincunt, pauca pro causa loquar	qva&s a_rma^ vi_ncu&nt p[au]ca^ pro_ c[au]sa_ lo^qva&r 	X_^_X_^_X_^X	1.0
Nostra. cruento cecidit in bello pater?	no&stra& cru^e_nto& ce^ci^di^t i&n be&llo_ pa^te&r	X_^_X^^^_X_^X	m
Cecidere fratres? arma non seruant modum;	ce^ci^de_re^ fra_tre&s a_rma^ no&n se&rva&nt mo^du&m 	^^_^_X_^_X_^X	1.0
Nec temperari facile nec reprimi potest	ne&c te_mpe^ra_ri& fa^ci^le^ ne&c re^pri^mi_ po^te&st	X_^_X^^^_^^_^X	m
Stricti ensis ira; bella delectat cruor.	stri&cti& e_nsi^s i_ra& be_lla^ de_le&cta&t cru^o&r 	X_^_X_^_X_^X	0.95
Sed ille regno pro suo, nos improba	se&d i_lle^ re_gno& pro& su^o_ no&s i_mpro^ba& 	X_^_X_^_X_^X	1.0
Cupidine acti? quaeritur belli exitus,	cu&pi_di^ne& a_cti& qv[ae]ri^tu&r be&lli& e_xi^tu&s 	X_^_X_^_X_^X	1.0
Non causa. sed nunc pereat omnis memoria:	no&n c[au]sa^ se&d nu&nc pe^re^a^t o_mni&s me^mo^ri^a& 	X_^_X^^^_X^^^X	1.0
Cum uictor arma posuit, et uictum decet	cu&m vi_cto^r a_rma& po^su^i^t e&t vi&ctu&m de^ce&t 	X_^_X^^^_X_^X	1.0
Deponere odia. non ut inflexo genu	de&po_ne^re& o^di^a& no_n u^t i_nfle&xo_ ge^nu& 	X_^^^X_^_X_^X	1.0
Regnantem adores petimus: hoc ipsum placet	re&gna_nte&m a^do_re&s pe^ti^mu^s ho_c i&psu&m pla^ce&t 	X_^_X^^^_X_^X	0.87
Animo ruinas quod capis magno tuas;	a^ni^mo_ ru^i_na&s qvo&d ca^pi&s ma&gno_ tu^a&s 	^^_^_X_^_X_^X	1.0
Es rege coniunx digna: sociemus toros.	e&s re_ge^ co_nju&nx di_gna^ so^ci^e&mu&s to^ro&s 	X_^_X_^^^X_^X	0.93
Gelidus per artus uadit exanguis tremor.	ge^li^du&s pe^r a_rtu&s va_di^t e_xa&ngvi&s tre^mo&r 	^^_^_X_^_X_^X	1.0
Quod facinus aures pepulit? haut equidem horrui,	quo&d fa^ci^nu^s [au]re&s pe^pu^li^t? h[au]t e^qui^de&m ho_rru^i_, 	X^^^_X^^^_^^_^X	m
Cum pace rupta bellicus muros fragor	cu&m pa_ce^ ru_pta& be_lli^cu&s mu&ro&s fra^go&r 	X_^_X_^_X_^X	1.0
Circumsonaret, pertuli intrepide omnia:	ci&rcu_mso^na_re&t pe_rtu^li& i_ntre^pi^de& o_mni^a& 	X_^_X_^_^^_^X	1.0
Thalamos tremesco; capta nunc uideor mihi. -	tha^la^mo&s tre^me_sco& ca_pta^ nu&nc vi^de^o&r mi^hi& 	^^_^_X_^_^^_^X	1.0
Grauent catenae corpus et longa fame	gra&ve&nt ca^te_n[ae] co_rpu^s e&t lo&nga_ fa^me& 	X_^_X_^_X_^X	1.0
Mors protrahatur lenta: non uincet fidem	mo&rs pro_tra^ha_tu&r le_nta^ no&n vi&nce&t fi^de&m 	X_^_X_^_X_^X	1.0
Vis ulla nostram; moriar, Alcide, tua.	vi&s u_lla^ no_stra&m mo^ri^a^r a_lci&de_ tu^a& 	X_^_X^^^_X_^X	1.0
Animosne mersus inferis coniunx facit?	a^ni^mo_sne^ me_rsu&s i_nfe^ri_s co&nju&nx fa^ci&t 	^^_^_X_^_X_^X	1.0
Inferna tetigit, posset ut supera assequi.	i&nfe_rna^ te^ti^gi&t po_sse^t u&t su^pe^ra& a_sse^qvi& 	X_^^^X_^_^^_^X	1.0
Telluris illum pondus immensae premit.	te&llu_ri^s i_llu&m po_ndu^s i_mme&ns[ae] pre^mi&t 	X_^_X_^_X_^X	1.0
Nullo premetur onere, qui caelum tulit.	nu&llo& pre^me_tu&r o^ne^re^ qvi_ c[ae]lu&m tu^li&t 	X_^_X^^^_X_^X	1.0
Cogere. Cogi qui potest nescit mori.	co&ge_re^ co_gi& qvi_ po^te&st ne&sci&t mo^ri& 	X_^_X_^_X_^X	0.25
Effare thalamis quod nouis potius parem	e&ffa_re^ tha^la^mi&s qvo&d no^vi&s po^ti^u&s pa^re&m 	X_^^^X_^_^^_^X	1.0
Regale munus. Aut tuam mortem aut meam.	re&ga_le^ mu_nu&s [au]t tu^a&m mo&rte&m [au]t me^a&m 	X_^_X_^_X_^X	1.0
Moriere demens. Coniugi occurram meo.	mo^ri^e_re^ de_me&ns co_nju^gi& o_ccu&rra&m me^o& 	^^_^_X_^_X_^X	1.0
Sceptrone nostro famulus est potior tibi?	sce&ptro_ne^ no_stro& fa^mu^lu^s e&st po^ti^o&r ti^bi& 	X_^_X^^^_^^_^X	1.0
Quot iste famulus tradidit reges neci!	qvo&t i_ste^ fa^mu^lu&s tra_di^di&t re&ge&s ne^ci& 	X_^^^X_^_X_^X	1.0
Cur ergo regi seruit et patitur iugum?	cu&r e_rgo^ re_gi& se_rvi^t e&t pa^ti^tu&r ju^gu&m 	X_^_X_^_^^_^X	0.45
Imperia dura tolle: quid uirtus erit?	i&mpe^ri^a^ du_ra& to_lle^ qvi&d vi&rtu_s e^ri&t 	X^^^_X_^_X_^X	1.0
Obici feris monstrisque uirtutem putas?	o^bi^ci_ fe^ri&s mo&nstri_sqve^ vi_rtu&te&m pu^ta&s	^^_^_X_^_X_^X	m
Virtutis est domare quae cuncti pauent.	vi&rtu_ti^s e&st do&ma_re^ qv[ae] cu&ncti_ pa^ve&nt 	X_^_X_^_X_^X	1.0
Tenebrae sequentem magna Tartareae premunt.	te^ne^br[ae] se^qve_nte&m ma_gna^ ta_rta^re^[ae] pre^mu&nt 	^^_^_X_^_^^_^X	0.38
Non est ad astra mollis e terris uia.	no&n e&st a^d a_stra& mo_lli^s e_ te&rri&s vi^a& 	X_^_X_^_X_^X	0.33
Quo patre genitus caelitum sperat domos?	qvo& pa_tre^ ge^ni^tu&s c[ae]li^tu_m spe&ra&t do^mo&s 	X_^^^X_^_X_^X	0.69
Miseranda coniunx Herculis magni, sile:	mi^se^ra_nda^ co_nju&nx he_rcu^li&s ma&gni_ si^le& 	^^_^_X_^_X_^X	1.0
Partes meae sunt reddere Alcidae patrem	pa&rte&s me^[ae] su&nt re_dde^re& a_lci&d[ae] pa^tre&m 	X_^_X_^_X_^X	0.69
Genusque uerum. post tot ingentis uiri	ge&nu_sqve^ ve_ru&m po&st to^t i_nge&nti&s vi^ri& 	X_^_X_^_X_^X	1.0
Memoranda facta postque pacatum manu	me^mo^ra_nda^ fa_cta& po_stqve^ pa_ca&tu&m ma^nu& 	^^_^_X_^_X_^X	1.0
Quodcumque Titan ortus et labens uidet,	qvo&dcu_mqve^ ti_ta&n o_rtu^s e&t la&be&ns vi^de&t 	X_^_X_^_X_^X	0.92
Post monstra tot perdomita, post Phlegram impio	po&st mo_nstra^ to&t pe&rdo^mi^ta^ po&st phle&gra&m i_mpi^o& 	X_^_X^^^_X_^X	1.0
Sparsam cruore postque defensos deos	spa&rsa&m cru^o_re& po_stqve^ de_fe&nso&s de^o&s 	X_^_X_^_X_^X	1.0
Nondum liquet de patre? mentimur Iouem?	no&ndu&m li^qve&t de& pa_tre^ me_nti&mu&r jo^ve&m 	X_^_X_^_X_^X	0.69
Iunonis odio crede. Quid uiolas Iouem?	ju&no_ni^s o^di^o& cre_de^ qvi&d vi^o^la&s jo^ve&m 	X_^^^X_^_^^_^X	1.0
Mortale caelo non potest iungi genus.	mo&rta_le^ c[ae]lo& no&n po^te&st ju&ngi_ ge^nu&s 	X_^_X_^_X_^X	1.0
Communis ista pluribus causa est deis.	co&mmu_ni^s i_sta& plu_ri^bu&s c[au]sa& e&st de^i&s 	X_^_X_^_X_^X	1.0
Famuline fuerant ante quam fierent dei?	fa^mu^li_ne^ fu^e^ra&nt a_nte^ qva&m fi^e^re&nt de^i&	^^_^^^X_^_^^_^X	m
Pastor Pheraeos Delius pauit greges.	pa&sto&r phe^r[ae]o&s de_li^u&s p[au]i&t gre^ge&s 	X_^_X_^_X_^X	1.0
Sed non per omnes exul errauit plagas.	se&d no&n pe^r o_mne&s e_xu^l e_rr[au]i&t pla^ga&s 	X_^_X_^_X_^X	0.75
Quem profuga terra mater errante edidit?	qve&m pro^fu^ga^ te_rra& ma_te^r e_rra&nte& e_di^di&t 	X^^^_X_^_X_^X	1.0
Num monstra saeua Phoebus aut timuit feras?	nu&m mo_nstra^ s[ae]va& ph[oe]bu^s [au]t ti^mu^i&t fe^ra&s 	X_^_X_^_^^_^X	1.0
Primus sagittas imbuit Phoebi draco.	pri&mu&s sa^gi_tta&s i_mbu^i&t ph[oe]bi& dra^co& 	X_^_X_^_X_^X	1.0
Quam grauia partus tulerit ignoras mala?	qva&m gra^vi^a^ pa_rtu&s tu^le^ri^t i_gno&ra&s ma^la& 	X^^^_X^^^_X_^X	0.94
E matris utero fulmine eiectus puer	e& ma_tri^s u^te^ro& fu_lmi^ne& [ei]e&ctu&s pu^e&r 	X_^^^X_^_X_^X	1.0
Mox fulminanti proximus patri stetit.	mo&x fu_lmi^na_nti& pro_xi^mu&s pa&tri& ste^ti&t 	X_^_X_^_X_^X	1.0
Quid? qui gubernat astra, qui nubes quatit,	qvi&d qvi_ gu^be_rna&t a_stra^ qvi_ nu&be&s qva^ti&t 	X_^_X_^_X_^X	1.0
Non latuit infans rupis exesae specu?	no&n la^tu^i^t i_nfa&ns ru_pi^s e_xe&sae& spe^cu& 	X^^^_X_^_X_^X	1.0
Sollicita tanti pretia natales habent	so&lli^ci^ta^ ta_nti& pre^ti^a^ na_ta&le_s ha^be&nt 	X^^^_X^^^_X_^X	1.0
Semperque magno constitit nasci deum.	se&mpe_rqve^ ma_gno& co_nsti^ti&t na&sci_ de^u&m 	X_^_X_^_X_^X	1.0
Quemcumque miserum uideris, hominem scias.	qve&mcu_mqve^ mi^se^ru&m vi_de^ri^s ho^mi&ne&m sci^a&s 	X_^^^X_^^^X_^X	0.67
Quemcumque fortem uideris, miserum neges.	qve&mcu_mqve^ fo_rte&m vi_de^ri&s mi^se^ru&m ne^ge&s 	X_^_X_^_^^_^X	0.67
Fortem uocemus cuius ex umeris leo,	fo&rte&m vo^ce_mu&s cu_ju^s e&x u^me^ri&s le^o& 	X_^_X_^_^^_^X	1.0
Donum puellae factus, et claua excidit	do&nu&m pu^e_ll[ae] fa_ctu^s e&t cl[au]a& e_xci^di&t 	X_^_X_^_X_^X	1.0
Fulsitque pictum ueste Sidonia latus?	fu&lsi_tqve^ pi_ctu&m ve_ste^ si_do^ni^a_ la^tu&s	X_^_X_^_^^_^X	m
Fortem uocemus cuius horrentes comae	fo&rte&m vo^ce_mu&s cu_ju^s ho_rre&nte&s co^m[ae] 	X_^_X_^_X_^X	1.0
Maduere nardo, laude qui notas manus	ma^du^e_re^ na_rdo& l[au]de^ qvi_ no&ta&s ma^nu&s 	^^_^_X_^_X_^X	1.0
Ad non uirilem tympani mouit sonum,	a&d no&n vi^ri_le&m ty_mpa^ni_ mo&vi&t so^nu&m 	X_^_X_^_X_^X	1.0
Mitra ferocem barbara frontem premens?	mi&tra_ fe^ro_ce&m ba_rba^ra_ fro&nte&m pre^me&ns 	X_^_X_^_X_^X	1.0
Non erubescit Bacchus effusos tener	no&n e_ru^be_sci&t ba_cchu^s e_ffu&so&s te^ne&r 	X_^_X_^_X_^X	1.0
Sparsisse crines nec manu molli leuem	spa&rsi_sse^ cri_ne&s ne&c ma^nu_ mo&lli_ le^ve&m 	X_^_X_^_X_^X	0.93
Vibrare thyrsum, cum parum forti gradu	vi&bra_re^ thy_rsu&m cu&m pa^ru&m fo&rti& gra^du& 	X_^_X_^_X_^X	1.0
Auro decorum syrma barbarico trahit:	[au]ro_ de^co_ru&m sy_rma^ ba_rba^ri^co& tra^hi&t 	X_^_X_^_^^_^X	1.0
Post multa uirtus opera laxari solet.	po&st mu_lta^ vi_rtu&s o^pe^ra^ la_xa&ri_ so^le&t 	X_^_X^^^_X_^X	1.0
Hoc Euryti fatetur euersi domus	ho&c [eu]ry^ti_ fa&te_tu^r [eu]e&rsi_ do^mu&s 	X_^_X_^_X_^X	1.0
Pecorumque ritu uirginum oppressi greges;	pe^co^ru_mqve^ ri_tu& vi_rgi^nu&m o_ppre&ssi& gre^ge&s 	^^_^_X_^_X_^X	1.0
Hoc nulla Iuno, nullus Eurystheus iubet:	ho&c nu_lla^ ju_no& nu_llu^s [eu]ry&sth[eu]s ju^be&t 	X_^_X_^_X_^X	1.0
Ipsius haec sunt opera. Non nosti omnia:	i&psi_u^s h[ae]c su&nt o^pe^ra^ no&n no&sti& o_mni^a& 	X_^_X^^^_X_^X	0.28
Ipsius opus est caestibus fractus suis	i&psi_u^s o^pu^s e&st c[ae]sti^bu&s fra&ctu&s su^i&s 	X_^^^X_^_X_^X	0.29
Eryx et Eryci iunctus Antaeus Libys,	e&ry&x e^t e^ry^ci& ju_nctu^s a_nt[ae]u&s li^by&s 	X_^^^X_^_X_^X	1.0
Et qui hospitali caede manantes foci	e&t qvi& ho_spi^ta_li& c[ae]de^ ma_na&nte&s fo^ci& 	X_^_X_^_X_^X	1.0
Bibere iustum sanguinem Busiridis;	bi&be_re^ ju_stu&m sa_ngvi^ne&m bu&si_ri^di&s 	X_^_X_^_X_^X	1.0
Ipsius opus est uulneri et ferro obuius	i&psi_u^s o^pu^s e&st vu_lne^ri& e&t fe&rro& o_bvi^u&s 	X_^^^X_^_X_^X	0.29
Mortem coactus integer Cycnus pati,	mo&rte&m co^a_ctu&s i_nte^ge&r cy&cnu&s pa^ti& 	X_^_X_^_X_^X	1.0
Nec unus una Geryon uictus manu.	ne&c u_nu^s u_na& ge_ry^o_n vi&ctu&s ma^nu& 	X_^_X_^_X_^X	1.0
Eris inter istos - qui tamen nullo stupro	e^ri^s i_nte^r i_sto&s qvi_ ta^me&n nu&llo& stu^pro& 	^^_^_X_^_X_^X	1.0
Laesere thalamos. Quod Ioui hoc regi licet:	l[ae]se_re^ tha^la^mo&s qvo&d jo^vi& ho&c re&gi_ li^ce&t 	X_^^^X_^_X_^X	1.0
Ioui dedisti coniugem, regi dabit;	jo&vi_ de^di_sti& co_nju^ge&m re&gi_ da^bi&t 	X_^_X_^_X_^X	1.0
Et te magistro non nouum hoc discet nurus,	e&t te_ ma^gi_stro& no&n no^vu&m ho&c di&sce&t nu^ru&s 	X_^_X_^_X_^X	1.0
Etiam uiro probante meliorem sequi.	e^ti^a&m vi^ro& pro&ba_nte^ me^li^o&re&m se^qvi& 	^^_^_X_^^^X_^X	1.0
Sin copulari pertinax taedis negat,	si&n co_pu^la_ri& pe_rti^na_x t[ae]di&s ne^ga&t 	X_^_X_^_X_^X	1.0
Vel ex coacta nobilem partum feram.	ve&l e&x co^a_cta& no_bi^le&m pa&rtu&m fe^ra&m 	X_^_X_^_X_^X	1.0
Vmbrae Creontis et penates Labdaci	u&mbr[ae] cre^o_nti&s e&t pe^na_te&s la_bda^ci& 	X_^_X_^_X_^X	1.0
Et nuptiales impii Oedipodae faces,	e&t nu_pti^a_le&s i_mpi^i& [oe]di^po^d[ae] fa^ce&s 	X_^_X_^_^^_^X	0.98
Nunc solita nostro fata coniugio date.	nu&nc so^li^ta^ no_stro& fa_ta^ co_nju^gi^o_ da^te& 	X^^^_X_^_^^_^X	1.0
Nunc nunc, cruentae regis Aegypti nurus,	nu&nc nu&nc cru^e_nt[ae] re_gi^s [ae]gy&pti_ nu^ru&s 	X_^_X_^_X_^X	0.99
Adeste multo sanguine infectae manus.	a&de_ste^ mu_lto& sa_ngvi^ne& i_nfe&ct[ae] ma^nu&s 	X_^_X_^_X_^X	1.0
Dest una numero Danais: explebo nefas.	de&st u_na^ nu^me^ro& da^na^i^s: e_xple_bo_ ne^fa&s. 	X_^^^X^^^_X_^X	m
Coniugia quoniam peruicax nostra abnuis	co&nju^gi^a^ qvo^ni^a&m pe_rvi^ca_x no&stra& a_bnu^i&s 	X^^^^^X_^_X_^X	1.0
Regemque terres, sceptra quid possint scies.	re&ge_mqve^ te_rre&s sce_ptra^ qvi&d po&ssi&nt sci^e&s 	X_^_X_^_X_^X	1.0
Complectere aras: nullus eripiet deus	co&mple_cte^re& a_ra&s nu_llu^s e_ri^pi^e&t de^u&s 	X_^_X_^_^^_^X	1.0
Te mihi, nec orbe si remolito queat	te& mi^hi^ ne^c o_rbe& si_ re^mo_li&to& qve^a&t 	X^^^_X_^_X_^X	0.81
Ad supera uictor lumina Alcides uehi.	a&d su^pe^ra^ vi_cto&r lu_mi^na& a_lci&de&s ve^hi& 	X^^^_X_^_X_^X	1.0
Congerite siluas: templa supplicibus suis	co&nge^ri^te^ si_lva&s te_mpla^ su_ppli^ci^bu&s su^i&s 	X^^^_X_^_^^_^X	1.0
Iniecta flagrent, coniugem et totum gregem	i&nje_cta^ fla_gre&nt co_nju^ge&m e&t to&tu&m gre^ge&m 	X_^_X_^_X_^X	1.0
Consumat unus igne subiecto rogus.	co&nsu_ma^t u_nu&s i_gne^ su_bje&cto_ ro^gu&s 	X_^_X_^_X_^X	1.0
Hoc munus a te genitor Alcidae peto,	ho&c mu_nu^s a_ te& ge^ni^to^r a_lci&d[ae] pe^to& 	X_^_X^^^_X_^X	0.01
Rogare quod me deceat, ut primus cadam.	ro&ga_re^ qvo&d me& de^ce^a^t u&t pri&mu&s ca^da&m 	X_^_X^^^_X_^X	1.0
Qui morte cunctos luere supplicium iubet	qvi& mo_rte^ cu_ncto&s lu^e^re^ su_ppli^ci^u&m ju^be&t 	X_^_X^^^_^^_^X	1.0
Nescit tyrannus esse: diuersa inroga;	ne&sci&t ty^ra_nnu&s e_sse^ di_ve&rsa& i_nro^ga& 	X_^_X_^_X_^X	1.0
Miserum ueta perire, felicem iube.	mi^se^ru&m ve^ta_ pe&ri_re^ fe_li&ce&m ju^be& 	^^_^_X_^_X_^X	1.0
Ego, dum cremandis trabibus accrescit rogus,	e^go^ du&m cre^ma_ndi&s tra^bi^bu^s a_ccre&sci&t ro^gu&s 	^^_^_X^^^_X_^X	1.0
Sacro regentem maria uotiuo colam.	sa&cro_ re^ge_nte&m ma^ri^a^ vo_ti&vo_ co^la&m 	X_^_X^^^_X_^X	1.0
Pro numinum uis summa, pro caelestium	pro& nu_mi^nu&m vi&s su_mma^ pro_ c[ae]le_sti^u&m 	X_^_X_^_X_^X	1.0
Rector parensque, cuius excussis tremunt	re&cto&r pa^re_nsqve& cu_ju^s e_xcu&ssi&s tre^mu&nt 	X_^_X_^_X_^X	0.97
Humana telis, impiam regis feri	hu&ma_na^ te_li&s i_mpi^a&m re&gi&s fe^ri& 	X_^_X_^_X_^X	1.0
Compesce dextram! - quid deos frustra precor?	co&mpe_sce^ de_xtra&m qvi&d de^o&s fru&stra_ pre^co&r 	X_^_X_^_X_^X	1.0
Vbicumque es, audi, gnate. - cur subito labant	u^bi^cu_mqve& e^s [au]di& gna_te^ cu&r su^bi^to^ la^ba&nt	^^_^_X_^_X^^^X	c
Agitata motu templa? cur mugit solum?	a^gi^ta_ta^ mo_tu& te_mpla^ cu&r mu&gi&t so^lu&m 	^^_^_X_^_X_^X	0.37
Infernus imo sonuit e fundo fragor.	i&nfe_rnu^s i_mo& so^nu^i^t e_ fu&ndo& fra^go&r 	X_^_X^^^_X_^X	1.0
Audimur! est est sonitus Herculei gradus.	[au]di_mu^r! e&st e&st so^ni^tu^s he_rcu^le^i& gra^du_s. 	X_^_X^^^_^^_^X	m
O lucis almae rector et caeli decus,	o& lu_ci^s a_lm[ae] re_cto^r e&t c[ae]li_ de^cu&s 	X_^_X_^_X_^X	0.97
Qui alterna curru spatia flammifero ambiens	qvi& a&lte_rna^ cu_rru& spa^ti^a^ fla_mmi^fe^ro& a_mbi^e&ns 	X_^_X^^^_^^_^X	1.0
Inlustre laetis exeris terris caput,	i&nlu_stre^ l[ae]ti&s e_xe^ri&s te&rri&s ca^pu&t 	X_^_X_^_X_^X	1.0
Da, Phoebe, ueniam, si quid inlicitum tui	da& ph[oe]be^ ve^ni^a&m si& qvi^d i_nli^ci^tu&m tu^i& 	X_^^^X_^_^^_^X	0.87
Videre uultus: iussus in lucem extuli	vi&de_re^ vu_ltu&s ju_ssu^s i&n lu&ce&m e_xtu^li& 	X_^_X_^_X_^X	1.0
Arcana mundi. tuque, caelestum arbiter	a&rca_na^ mu_ndi& tu_qve^ c[ae]le&stu&m a_rbi^te&r 	X_^_X_^_X_^X	1.0
Parensque, uisus fulmine opposito tege;	pa&re_nsqve^ vi_su&s fu_lmi^ne& o_ppo^si^to_ te^ge& 	X_^_X_^_^^_^X	1.0
Et tu, secundo maria qui sceptro regis,	e&t tu_ se^cu_ndo& ma^ri^a^ qvi& sce&ptro_ re^gi&s 	X_^_X^^^_X_^X	0.01
Imas pete undas. quisquis ex alto aspicit	i&ma&s pe^te& u_nda&s qvi_sqvi^s e&x a&lto& a_spi^ci&t 	X_^_X_^_X_^X	1.0
Terrena, facie pollui metuens noua,	te_rre_na^, fa^ci^e_ po_llu^i_ me^tu^e&ns no^ua&, 	X_^^^X_^_^^_^X	m
Aciem reflectat oraque in caelum erigat	a^ci^e&m re^fle_cta&t o_ra^qve& i&n c[ae]lu&m e_ri^ga&t 	^^_^_X_^_X_^X	1.0
Portenta fugiens: hoc nefas cernant duo,	po&rte_nta^ fu^gi^e&ns ho&c ne^fa&s ce&rna&nt du^o& 	X_^^^X_^_X_^X	1.0
Qui aduexit et quae iussit. in poenas meas	qvi& a&dve_xi^t e&t qv[ae] ju_ssi^t i&n p[oe]na&s me^a&s 	X_^_X_^_X_^X	1.0
Atque in labores non satis terrae patent	a&tqve& i&n la^bo_re&s no&n sa^ti&s te&rr[ae] pa^te&nt 	X_^_X_^_X_^X	1.0
Iunonis odio: uidi inaccessa omnibus,	ju&no_ni^s o^di^o& vi_di& i^na_cce&ssa& o_mni^bu&s 	X_^^^X_^_X_^X	1.0
Ignota Phoebo quaeque deterior polus	i&gno_ta^ ph[oe]bo& qv[ae]qve^ de_te^ri^o&r po^lu&s 	X_^_X_^_^^_^X	1.0
Obscura diro spatia concessit Ioui;	o&bscu_ra^ di_ro& spa^ti^a^ co_nce&ssi&t jo^vi& 	X_^_X^^^_X_^X	1.0
Et, si placerent tertiae sortis loca,	e&t si& pla^ce_re&nt te_rti^ae_ so&rti&s lo^ca& 	X_^_X_^_X_^X	1.0
Regnare potui: noctis aeternae chaos	re&gna_re^ po^tu^i& no_cti^s [ae]te&rn[ae] cha^o&s 	X_^^^X_^_X_^X	1.0
Et nocte quiddam grauius et tristes deos	e&t no_cte^ qvi_dda&m gra^vi^u^s e&t tri&ste&s de^o&s 	X_^_X^^^_X_^X	1.0
Et fata uici. morte contempta redi:	e&t fa_ta^ vi_ci& mo_rte^ co_nte&mpta_ re^di& 	X_^_X_^_X_^X	1.0
Quid restat aliud? uidi et ostendi inferos:	qvi&d re_sta^t a^li^u&d vi_di& e^t o_ste&ndi& i_nfe^ro&s 	X_^^^X_^_X_^X	1.0
Da si quid ultra est, iam diu pateris manus	da& si& qvi^d u_ltra& e&st ja&m di^u_ pa^te^ri&s ma^nu&s 	X_^_X_^_^^_^X	1.0
Cessare nostras, Iuno: quae uinci iubes?	ce&ssa_re^ no_stra&s ju_no^ qv[ae] vi&nci_ ju^be&s 	X_^_X_^_X_^X	0.47
Sed templa quare miles infestus tenet	se&d te_mpla^ qva_re& mi_le^s i_nfe&stu&s te^ne&t 	X_^_X_^_X_^X	1.0
Limenque sacrum terror armorum obsidet?	li&me_nqve^ sa_cru&m te_rro^r a_rmo&ru&m o_bsi^de&t 	X_^_X_^_X_^X	0.68
Vtrumne uisus uota decipiunt meos,	u&tru_mne^ vi_su&s vo_ta^ de_ci^pi^u&nt me^o&s	X_^_X_^_^^_^X	m
An ille domitor orbis et Graium decus	a&n i_lle^ do^mi^to&r o_rbi^s e&t gra&ju&m de^cu&s 	X_^^^X_^_X_^X	0.88
Tristi silentem nubilo liquit domum?	tri&sti_ si^le_nte&m nu_bi^lo_ li&qvi&t do^mu&m 	X_^_X_^_X_^X	1.0
Estne ille natus? membra laetitia stupent.	e&stne& i_lle^ na_tu&s me_mbra^ l[ae]ti^ti^a& stu^pe&nt 	X_^_X_^_^^_^X	1.0
O nate, certa at sera Thebarum salus,	o& na_te^ ce_rta& a&t se_ra^ the_ba&ru&m sa^lu&s 	X_^_X_^_X_^X	1.0
Teneone in auras editum an uana fruor	te^ne^o_ne& i^n [au]ra&s e_di^tu&m a&n va&na& fru^o&r	^^_^_X_^_X_^X	m
Deceptus umbra? tune es? agnosco toros	de&ce_ptu^s u_mbra& tu_ne& e^s a_gno&sco_ to^ro&s 	X_^_X_^_X_^X	0.96
Vmerosque et alto nobile in trunco caput.	u^me^ro_sqve& e^t a_lto& no_bi^le& i&n tru&nco_ ca^pu&t 	^^_^_X_^_X_^X	1.0
Vnde iste, genitor, squalor et lugubribus	u&nde& i_ste^ ge^ni^to&r sqva_lo^r e&t lu&gu_bri^bu&s 	X_^^^X_^_X_^X	1.0
Amicta coniunx? unde tam foedo obsiti	a&mi_cta^ co_nju&nx u_nde^ ta&m f[oe]do& o_bsi^ti& 	X_^_X_^_X_^X	1.0
Paedore nati? quae domum clades grauat?	p[ae]do_re^ na_ti& qv[ae] do^mu&m cla&de&s gra^va&t 	X_^_X_^_X_^X	1.0
Socer est peremptus, regna possedit Lycus,	so^ce^r e&st pe^re_mptu&s re_gna^ po_sse&di&t ly^cu&s 	^^_^_X_^_X_^X	1.0
Natos parentem coniugem leto petit.	na&to&s pa^re_nte&m co_nju^ge&m le&to_ pe^ti&t 	X_^_X_^_X_^X	1.0
Ingrata tellus, nemo ad Herculeae domus	i&ngra_ta^ te_llu&s ne_mo& a^d he_rcu^le^[ae] do^mu&s 	X_^_X_^_^^_^X	1.0
Auxilia uenit? uidit hoc tantum nefas	[au]xi^li^a^ ve_ni&t vi_di^t ho&c ta&ntu&m ne^fa&s 	X^^^_X_^_X_^X	0.43
Defensus orbis? - cur diem questu tero?	de&fe_nsu^s o_rbi&s cu&r di^e&m qve&stu_ te^ro& 	X_^_X_^_X_^X	1.0
Mactetur hostis, hanc ferat uirtus notam	ma&cte_tu^r ho_sti&s ha&nc fe^ra&t vi&rtu&s no^ta&m 	X_^_X_^_X_^X	0.57
Fiatque summus hostis Alcidae Lycus.	fi&a_tqve^ su_mmu&s ho_sti^s a_lci&d[ae] ly^cu&s 	X_^_X_^_X_^X	0.93
Ad hauriendum sanguinem inimicum feror;	a&d h[au]ri^e_ndu&m sa_ngvi^ne&m i^ni^mi&cu&m fe^ro&r 	X_^_X_^^^X_^X	1.0
Theseu, resiste, ne qua uis subita ingruat.	the&s[eu] re^si_ste& ne& qva^ vi&s su^bi^ta& i_ngru^a&t 	X_^_X_^_^^_^X	1.0
Me bella poscunt, differ amplexus, parens,	me& be_lla^ po_scu&nt di_ffe^r a_mple&xu&s pa^re&ns 	X_^_X_^_X_^X	0.97
Coniunxque differ. nuntiet Diti Lycus	co&nju_nxqve^ di_ffe&r nu_nti^e&t di&ti_ ly^cu&s 	X_^_X_^_X_^X	1.0
Me iam redisse. Flebilem ex oculis fuga,	me& ja&m re^di_sse& fle_bi^le&m e&x o^cu^li&s fu^ga& 	X_^_X_^_^^_^X	1.0
Regina, uultum, tuque nato sospite	re&gi_na^ vu_ltu&m tu_qve^ na_to& so_spi^te& 	X_^_X_^_X_^X	1.0
Lacrimas cadentes reprime: si noui Herculem,	la^cri^ma&s ca^de_nte&s re^pri^me^ si_ no&vi& he_rcu^le&m 	^^_^_X^^^_X_^X	1.0
Lycus Creonti debitas poenas dabit.	ly&cu&s cre^o_nti& de_bi^ta&s p[oe]na&s da^bi&t 	X_^_X_^_X_^X	1.0
Lentum est dabit: dat; hoc quoque est lentum: dedit.	le&ntu&m e&st da^bi&t da&t ho&c qvo^qve& e&st le&ntu&m de^di&t 	X_^_X_^_X_^X	0.93
Votum secundet qui potest nostrum deus	vo&tu&m se^cu_nde&t qvi_ po^te&st no&stru&m de^u&s 	X_^_X_^_X_^X	1.0
Rebusque lassis adsit. O magni comes	re&bu_sqve^ la_ssi&s a_dsi^t o_ ma&gni_ co^me&s 	X_^_X_^_X_^X	1.0
Magnanime nati, pande uirtutum ordinem,	ma&gna^ni^me^ na_ti& pa_nde^ vi_rtu&tu&m o_rdi^ne&m 	X^^^_X_^_X_^X	1.0
Quam longa maestos ducat ad manes uia,	qva&m lo_nga^ m[ae]sto&s du_ca^t a&d ma&ne&s vi^a& 	X_^_X_^_X_^X	1.0
Vt uincla tulerit dura Tartareus canis.	u&t vi_ncla^ tu^le^ri&t du_ra^ ta_rta^re^u&s ca^ni&s 	X_^^^X_^_^^_^X	0.4
Memorare cogis acta securae quoque	me^mo^ra_re^ co_gi&s a_cta^ se_cu&r[ae] qvo^qve& 	^^_^_X_^_X_^X	0.93
Horrenda menti. uix adhuc certa est fides	ho&rre_nda^ me_nti& vi&x a^dhu&c ce&rta& e&st fi^de&s 	X_^_X_^_X_^X	1.0
Vitalis aurae, torpet acies luminum	vi&ta_li^s [au]r[ae] to_rpe^t a^ci^e&s lu_mi^nu&m 	X_^_X_^^^X_^X	1.0
Hebetesque uisus uix diem insuetum ferunt.	he^be^te_sqve^ vi_su&s vi&x di^e&m i_nsve&tu&m fe^ru&nt 	^^_^_X_^_X_^X	1.0
Peruince, Theseu, quidquid alto in pectore	pe&rvi_nce^ the_s[eu] qvi_dqvi^d a_lto& i&n pe_cto^re& 	X_^_X_^_X_^X	1.0
Remanet pauoris neue te fructu optimo	re^ma^ne&t pa^vo_ri&s n[eu]e^ te& fru&ctu& o_pti^mo& 	^^_^_X_^_X_^X	1.0
Frauda laborum: quae fuit durum pati,	fr[au]da_ la^bo_ru&m qv[ae] fu^i&t du&ru&m pa^ti& 	X_^_X_^_X_^X	1.0
Meminisse dulce est. fare casus horridos.	me^mi^ni_sse^ du_lce& e&st fa_re^ ca_su&s ho_rri^do&s 	^^_^_X_^_X_^X	1.0
Fas omne mundi teque dominantem precor	fa&s o_mne^ mu_ndi& te_qve^ do^mi^na&nte&m pre^co&r 	X_^_X_^^^X_^X	1.0
Regno capaci teque quam toto inrita	re&gno_ ca^pa_ci& te_qve^ qva&m to&to& i_nri^ta& 	X_^_X_^_X_^X	1.0
Quaesiuit orbe mater, ut iura abdita	qv[ae]si_vi^t o_rbe& ma_te^r u&t ju&ra& a_bdi^ta& 	X_^_X_^_X_^X	1.0
Et operta terris liceat impune eloqui.	e^t o^pe_rta^ te_rri&s li^ce^a^t i_mpu&ne& e_lo^qvi& 	^^_^_X^^^_X_^X	1.0
Spartana tellus nobile attollit iugum,	spa&rta_na^ te_llu&s no_bi^le& a_tto&lli&t ju^gu&m 	X_^_X_^_X_^X	1.0
Densis ubi aequor Taenarus siluis premit;	de&nsi_s u^bi& [ae]qvo&r t[ae]na^ru_s si&lvi&s pre^mi&t 	X_^_X_^_X_^X	1.0
Hic ora soluit Ditis inuisi domus	hi&c o_ra^ so_lvi&t di_ti^s i_nvi&si_ do^mu&s 	X_^_X_^_X_^X	1.0
Hiatque rupes alta et immenso specu	hi&a_tqve^ ru_pe&s a_lta& e^t i_mme&nso& spe^cu& 	X_^_X_^_X_^X	1.0
Ingens uorago faucibus uastis patet	i&nge&ns vo^ra_go& f[au]ci^bu&s va&sti&s pa^te&t 	X_^_X_^_X_^X	1.0
Latumque pandit omnibus populis iter.	la&tu_mqve^ pa_ndi&t o_mni^bu&s po^pu^li_s i^te&r 	X_^_X_^_^^_^X	1.0
Non caeca tenebris incipit primo uia;	no&n c[ae]ca^ te^ne^bri&s i_nci^pi&t pri&mo_ vi^a& 	X_^^^X_^_X_^X	0.5
Tenuis relictae lucis a tergo nitor	te^nu^i&s re^li_ct[ae] lu_ci^s a_ te_rgo_ ni^to&r	^^_^_X_^_X_^X	m
Fulgorque dubius solis adflicti cadit	fu&lgo_rqve^ du^bi^u&s so_li^s a_dfli&cti_ ca^di&t 	X_^^^X_^_X_^X	0.86
Et ludit aciem: nocte sic mixta solet	e&t lu_di^t a^ci^e&m no_cte^ si&c mi&xta_ so^le&t 	X_^^^X_^_X_^X	1.0
Praebere lumen primus aut serus dies.	pr[ae]be_re^ lu_me&n pri_mu^s [au]t se&ru&s di^e&s 	X_^_X_^_X_^X	0.99
Hinc ampla uacuis spatia laxantur locis,	hi&nc a_mpla^ va^cu^i&s spa^ti^a^ la_xa&ntu&r lo^ci&s 	X_^^^X^^^_X_^X	1.0
In quae omne mersum pergat humanum genus.	i&n qv[ae] o_mne^ me_rsu&m pe_rga^t hu_ma&nu&m ge^nu&s 	X_^_X_^_X_^X	1.0
Nec ire labor est; ipsa deducit uia:	ne&c i_re^ la^bo^r e&st i_psa^ de_du&ci&t vi^a& 	X_^^^X_^_X_^X	0.97
Vt saepe puppes aestus inuitas rapit,	u&t s[ae]pe^ pu_ppe&s [ae]stu^s i_nvi&ta&s ra^pi&t 	X_^_X_^_X_^X	0.9
Sic pronus aer urguet atque auidum chaos,	si&c pro_nu^s a_e&r u_rgve^t a_tqve& a^vi^du&m cha^o&s 	X_^_X_^_^^_^X	1.0
Gradumque retro flectere haut umquam sinunt	gra&du_mqve^ re_tro& fle_cte^re& h[au]t u&mqva&m si^nu&nt 	X_^_X_^_X_^X	0.65
Vmbrae tenaces. Intus immenso sinu	u&mbr[ae] te^na_ce&s i_ntu^s i_mme&nso_ si^nu& 	X_^_X_^_X_^X	1.0
Placido quieta labitur Lethe uado	pla^ci^do& qvi^e_ta& la_bi^tu&r le&the_ va^do& 	^^_^_X_^_X_^X	0.87
Demitque curas, neue remeandi amplius	de&mi_tqve^ cu_ra&s n[eu]e^ re^me^a&ndi& a_mpli^u&s 	X_^_X_^^^X_^X	1.0
Pateat facultas, flexibus multis grauem	pa^te^a&t fa^cu_lta&s fle_xi^bu&s mu&lti&s gra^ve&m 	^^_^_X_^_X_^X	1.0
Inuoluit amnem: qualis incertis uagus	i&nvo_lvi^t a_mne&m qva_li^s i_nce&rti&s va^gu&s 	X_^_X_^_X_^X	1.0
Maeander undis ludit et cedit sibi	m[ae]a_nde^r u_ndi&s lu_di^t e&t ce&di&t si^bi& 	X_^_X_^_X_^X	1.0
Instatque dubius litus an fontem petat.	i&nsta_tqve^ du^bi^u&s li_tu^s a&n fo&nte&m pe^ta&t 	X_^^^X_^_X_^X	1.0
Palus inertis foeda Cocyti iacet;	pa&lu_s i^ne_rti&s f[oe]da^ co_cy&ti_ ja^ce&t 	X_^_X_^_X_^X	1.0
Hic uultur, illic luctifer bubo gemit	hi&c vu_ltu^r i_lli&c lu_cti^fe&r bu&bo_ ge^mi&t 	X_^_X_^_X_^X	1.0
Omenque triste resonat infaustae strigis.	o&me_nqve^ tri_ste& re^so^na^t i_nf[au]st[ae] stri^gi&s 	X_^_X^^^_X_^X	1.0
Horrent opaca fronde nigrantes comae	ho&rre&nt o^pa_ca& fro_nde^ ni_gra&nte&s co^m[ae] 	X_^_X_^_X_^X	1.0
Taxo imminente, quam tenet segnis Sopor,	ta&xo& i_mmi^ne_nte& qva&m te^ne&t se&gni&s so^po&r 	X_^_X_^_X_^X	1.0
Famesque maesta tabido rictu iacet	fa&me_sqve^ m[ae]sta& ta_bi^do_ ri&ctu_ ja^ce&t 	X_^_X_^_X_^X	1.0
Pudorque serus conscios uultus tegit.	pu&do_rqve^ se_ru&s co_nsci^o&s vu&ltu&s te^gi&t 	X_^_X_^_X_^X	1.0
Metus Pauorque, Funus et frendens Dolor	me&tu&s pa^vo_rqve& fu_nu^s e&t fre&nde&ns do^lo&r 	X_^_X_^_X_^X	1.0
Aterque Luctus sequitur et Morbus tremens	a&te_rqve^ lu_ctu&s se^qvi^tu^r e&t mo&rbu&s tre^me&ns 	X_^_X^^^_X_^X	1.0
Et cincta ferro Bella; in extremo abdita	e&t ci_ncta^ fe_rro& be_lla& i^n e_xtre&mo& a_bdi^ta& 	X_^_X_^_X_^X	1.0
Iners Senectus adiuuat baculo gradum.	i&ne&rs se^ne_ctu&s a_dju^va&t ba^cu^lo& gra^du&m 	X_^_X_^_^^_^X	1.0
Estne aliqua tellus Cereris aut Bacchi ferax?	e&stne& a^li^qva^ te_llu&s ce^re^ri^s [au]t ba&cchi_ fe^ra&x 	X^^^_X^^^_X_^X	1.0
Non prata uiridi laeta facie germinant	no&n pra_ta^ vi^ri^di& l[ae]ta^ fa^ci^e& ge_rmi^na&nt 	X_^^^X_^^^X_^X	1.0
Nec adulta leni fluctuat Zephyro seges;	ne^c a^du_lta^ le_ni& flu_ctu^a&t ze^phy^ro_ se^ge&s 	^^_^_X_^_^^_^X	1.0
Non ulla ramos silua pomiferos habet:	no&n u_lla^ ra_mo&s si_lva^ po_mi^fe^ro&s ha^be&t	X_^_X_^_^^_^X	m
Sterilis profundi uastitas squalet soli	ste^ri^li&s pro^fu_ndi& va_sti^ta_s sqva&le&t so^li& 	^^_^_X_^_X_^X	0.24
Et foeda tellus torpet aeterno situ.	e&t f[oe]da^ te_llu&s to_rpe^t [ae]te&rno_ si^tu& 	X_^_X_^_X_^X	1.0
Rerumque maestus finis et mundi ultima	re&ru_mqve^ m[ae]stu&s fi_ni^s e&t mu&ndi& u_lti^ma& 	X_^_X_^_X_^X	0.77
Immotus aer haeret et pigro sedet	i&mmo_tu^s a_e&r h[ae]re^t e&t pi&gro_ se^de&t 	X_^_X_^_X_^X	1.0
Nox atra mundo: cuncta maerore horrida	no&x a_tra^ mu_ndo& cu_ncta^ m[ae]ro&re& ho_rri^da& 	X_^_X_^_X_^X	1.0
Ipsaque morte peior est mortis locus.	i&psa_qve^ mo_rte& p[ei]o^r e&st mo&rti&s lo^cu&s 	X_^_X_^_X_^X	1.0
Quid ille opaca qui regit sceptro loca?	qvi&d i_lle& o^pa_ca& qvi_ re^gi&t sce&ptro_ lo^ca& 	X_^_X_^_X_^X	1.0
Qua sede positus temperat populos leues?	qva& se_de^ po^si^tu&s te_mpe^ra&t po^pu^lo&s le^ve&s 	X_^^^X_^_^^_^X	0.96
Est in recessu Tartari obscuro locus,	e&st i&n re^ce_ssu& ta_rta^ri& o_bscu&ro_ lo^cu&s 	X_^_X_^_X_^X	1.0
Quem grauibus umbris spissa caligo alligat.	qve&m gra^vi^bu^s u_mbri&s spi_ssa^ ca_li&go& a_lli^ga&t 	X^^^_X_^_X_^X	1.0
A fonte discors manat hinc uno latex,	a& fo_nte^ di_sco&rs ma_na^t hi&nc u&no_ la^te&x 	X_^_X_^_X_^X	1.0
Alter quieto similis (hunc iurant dei)	a&lte&r qvi^e_to& si^mi^li^s hu&nc ju&ra&nt de^i& 	X_^_X^^^_X_^X	1.0
Tacente sacram deuehens fluuio Styga;	ta&ce_nte^ sa_cra&m de_ve^he_ns flu^vi^o& sty^ga& 	X_^_X_^_^^_^X	0.33
At hic tumultu rapitur ingenti ferox	a&t hi&c tu^mu_ltu& ra^pi^tu^r i_nge&nti_ fe^ro&x 	X_^_X^^^_X_^X	1.0
Et saxa fluctu uoluit Acheron inuius	e&t sa_xa^ flu_ctu& vo_lvi^t a^che^ro&n i_nvi^u&s	X_^_X_^^^X_^X	m
Renauigari. cingitur duplici uado	re&na_vi^ga_ri& ci_ngi^tu&r du^pli^ci_ va^do& 	X_^_X_^_^^_^X	0.87
Aduersa Ditis regia, atque ingens domus	a&dve_rsa^ di_ti&s re_gi^a& a_tqve& i&nge&ns do^mu&s 	X_^_X_^_X_^X	1.0
Vmbrante luco tegitur. hic uasto specu	u&mbra_nte^ lu_co& te^gi^tu^r hi&c va&sto& spe^cu& 	X_^_X^^^_X_^X	1.0
Pendent tyranni limina, hoc umbris iter,	pe&nde&nt ty^ra_nni& li_mi^na& ho_c u&mbri_s i^te&r 	X_^_X_^_X_^X	1.0
Haec porta regni. campus hanc circa iacet,	h[ae]c po_rta^ re_gni& ca_mpu^s ha&nc ci&rca_ ja^ce&t 	X_^_X_^_X_^X	1.0
In quo superbo digerit uultu sedens	i&n qvo_ su^pe_rbo& di_ge^ri&t vu&ltu_ se^de&ns 	X_^_X_^_X_^X	1.0
Animas recentes. dira maiestas deo,	a^ni^ma&s re^ce_nte&s di_ra^ ma_je&sta&s de^o& 	^^_^_X_^_X_^X	1.0
Frons torua, fratrum quae tamen specimen gerat	fro&ns to_rva^ fra_tru&m qv[ae] ta^me&n spe^ci^me&n ge^ra&t 	X_^_X_^_^^_^X	1.0
Gentisque tantae, uultus est illi Iouis,	ge&nti_sqve^ ta_nt[ae] vu_ltu^s e&st i&lli_ jo^vi&s 	X_^_X_^_X_^X	0.35
Sed fulminantis: magna pars regni trucis	se&d fu_lmi^na_nti&s ma_gna^ pa&rs re&gni& tru^ci&s 	X_^_X_^_X_^X	1.0
Est ipse dominus, cuius aspectus timet	e&st i_pse^ do^mi^nu&s cu_ju^s a_spe&ctu&s ti^me&t 	X_^^^X_^_X_^X	1.0
Quidquid timetur. Verane est fama inferis	qvi&dqvi&d ti^me_tu&r ve_ra^ne& e&st fa&ma& i_nfe^ri&s 	X_^_X_^_X_^X	1.0
Tam sera reddi iura et oblitos sui	ta&m se_ra^ re_ddi& ju_ra& e^t o_bli&to&s su^i& 	X_^_X_^_X_^X	1.0
Sceleris nocentes debitas poenas dare?	sce^le^ri&s no^ce_nte&s de_bi^ta&s p[oe]na&s da^re& 	^^_^_X_^_X_^X	1.0
Quis iste ueri rector atque aequi arbiter?	qvi&s i_ste^ ve_ri& re_cto^r a_tqve& [ae]qvi& a_rbi^te&r 	X_^_X_^_X_^X	1.0
Non unus alta sede quaesitor sedens	no&n u_nu^s a_lta& se_de^ qv[ae]si&to&r se^de&ns 	X_^_X_^_X_^X	0.98
Iudicia trepidis sera sortitur reis.	iu_di^ci^a^ tre^pi^di&s se_ra^ so_rti_tu&r re^i&s. 	X^^^^^X_^_X_^X	m
Aditur illo Gnosius Minos foro,	a&di_tu^r i_llo& gno_si^u&s mi&no&s fo^ro& 	X_^_X_^_X_^X	1.0
Rhadamanthus illo, Thetidis hoc audit socer.	rha^da^ma_nthu^s i_llo& the^ti^di^s ho_c [au]di&t so^ce&r 	^^_^_X^^^_X_^X	1.0
Quod quisque fecit, patitur; auctorem scelus	qvo&d qvi_sqve^ fe_ci&t pa^ti^tu^r [au]cto&re&m sce^lu&s 	X_^_X^^^_X_^X	1.0
Repetit suoque premitur exemplo nocens:	re^pe^ti&t su^o_qve& pre^mi^tu^r e_xe&mplo_ no^ce&ns 	^^_^_X^^^_X_^X	1.0
Vidi cruentos carcere includi duces	vi&di& cru^e_nto&s ca_rce^re& i_nclu&di_ du^ce&s 	X_^_X_^_X_^X	1.0
Et impotentis terga plebeia manu	e&t i_mpo^te_nti&s te_rga^ ple_b[ei]a_ ma^nu& 	X_^_X_^_X_^X	1.0
Scindi tyranni. quisquis est placide potens	sci&ndi_ ty^ra_nni& qvi_sqvi^s e&st pla^ci^de_ po^te&ns 	X_^_X_^_^^_^X	1.0
Dominusque uitae seruat innocuas manus	do^mi^nu_sqve^ vi_t[ae] se_rva^t i_nno^cu^a&s ma^nu&s 	^^_^_X_^_^^_^X	1.0
Et incruentum mitis imperium regit	e&t i_ncru^e_ntu&m mi_ti^s i_mpe^ri^u&m re^gi&t 	X_^_X_^_^^_^X	1.0
Animoque parcit, longa permensus diu	a^ni^mo_qve^ pa_rci&t lo_nga^ pe_rme&nsu&s di^u& 	^^_^_X_^_X_^X	1.0
Felicis aeui spatia uel caelum petit	fe&li_ci^s [ae]vi& spa^ti^a^ ve&l c[ae]lu&m pe^ti&t 	X_^_X^^^_X_^X	1.0
Vel laeta felix nemoris Elysii loca,	ve&l l[ae]ta^ fe_li&x ne^mo^ri^s e_ly^si^i_ lo^ca& 	X_^_X^^^_^^_^X	1.0
Iudex futurus. sanguine humano abstine	ju&de&x fu^tu_ru&s sa_ngvi^ne& hu_ma&no& a_bsti^ne& 	X_^_X_^_X_^X	1.0
Quicumque regnas: scelera taxantur modo	qvi&cu_mqve^ re_gna&s sce^le^ra^ ta_xa&ntu&r mo^do& 	X_^_X^^^_X_^X	1.0
Maiore uestra. Certus inclusos tenet	ma&jo_re^ ve_stra& ce_rtu^s i_nclu&so&s te^ne&t 	X_^_X_^_X_^X	1.0
Locus nocentes? utque fert fama, impios	lo&cu&s no^ce_nte&s u_tqve^ fe&rt fa&ma& i_mpi^o&s 	X_^_X_^_X_^X	1.0
Supplicia uinclis saeua perpetuis domant?	su&ppli^ci^a^ vi_ncli&s s[ae]va^ pe_rpe^tu^i&s do^ma&nt 	X^^^_X_^_^^_^X	1.0
Rapitur uolucri tortus Ixion rota;	ra^pi^tu&r vo^lu_cri& to_rtu^s i_xi&o&n ro^ta& 	^^_^_X_^_X_^X	0.17
Ceruice saxum grande Sisyphia sedet;	ce&rvi_ce^ sa_xu&m gra_nde^ si_sy^phi^a_ se^de&t	X_^_X_^_^^_^X	m
In amne medio faucibus siccis senex	i&n a_mne^ me^di^o& f[au]ci^bu&s si&cci&s se^ne&x 	X_^^^X_^_X_^X	1.0
Sectatur undas, alluit mentum latex,	se&cta_tu^r u_nda&s a_llu^i&t me&ntu&m la^te&x 	X_^_X_^_X_^X	1.0
Fidemque cum iam saepe decepto dedit,	fi&de_mqve^ cu&m ja&m s[ae]pe^ de_ce&pto_ de^di&t 	X_^_X_^_X_^X	1.0
Perit unda in ore; poma destituunt famem.	pe^ri^t u_nda& i^n o_re& po_ma^ de_sti^tu^u&nt fa^me&m 	^^_^_X_^_^^_^X	0.7
Praebet uolucri Tityos aeternas dapes	pr[ae]be&t vo^lu_cri& ti^ty^o^s [ae]te&rna&s da^pe&s 	X_^_X^^^_X_^X	0.17
Vrnasque frustra Danaides plenas gerunt;	v_rna_sque^ fru_stra_ da^na^i^de&s ple&na&s ge^ru&nt; 	X_^_X^^^_X_^X	m
Errant furentes impiae Cadmeides	e&rra&nt fu^re_nte&s i_mpi^ae_ ca&dme_i^de&s 	X_^_X_^_X_^X	1.0
Terretque mensas auida Phineas auis.	te&rre_tqve^ me_nsa&s a^vi^da^ phi_ne&a_s a^vi&s 	X_^_X^^^_X_^X	1.0
Nunc ede nati nobilem pugnam mei.	nu&nc e_de^ na_ti& no_bi^le&m pu&gna&m me^i& 	X_^_X_^_X_^X	1.0
Patrui uolentis munus an spolium refert?	pa^tru^i_ vo^le_nti&s mu_nu^s a&n spo^li^u&m re^fe_rt	^^_^_X_^_^^_^X	m
Ferale tardis imminet saxum uadis,	fe&ra_le^ ta_rdi&s i_mmi^ne&t sa&xu&m va^di&s 	X_^_X_^_X_^X	0.88
Stupente ubi unda segne torpescit fretum.	stu&pe_nte& u^bi& u_nda& se_gne^ to_rpe&sci&t fre^tu&m 	X_^_X_^_X_^X	0.96
Hunc seruat amnem cultu et aspectu horridus	hu&nc se_rva^t a_mne&m cu_ltu& e^t a_spe&ctu& ho_rri^du&s 	X_^_X_^_X_^X	1.0
Pauidosque manes squalidus gestat senex.	pa^vi^do_sqve^ ma_ne&s sqva_li^du&s ge&sta&t se^ne&x 	^^_^_X_^_X_^X	1.0
Impexa pendet barba, deformem sinum	i&mpe_xa^ pe_nde&t ba_rba^ de_fo&rme&m si^nu&m 	X_^_X_^_X_^X	1.0
Nodus coercet, concauae lucent genae;	no&du&s co^e_rce&t co_nca^v[ae] lu&ce&nt ge^n[ae] 	X_^_X_^_X_^X	1.0
Regit ipse longo portitor conto ratem.	re^gi^t i_pse^ lo_ngo& po_rti^to&r co&nto_ ra^te&m 	^^_^_X_^_X_^X	1.0
Hic onere uacuus litori puppem applicans	hi&c o^ne^re^ va^cu^u&s li_to^ri_ pu&ppe&m a_ppli^ca&ns 	X^^^^^X_^_X_^X	1.0
Repetebat umbras; poscit Alcides uiam	re^pe^te_ba^t u_mbra&s po_sci^t a_lci&de&s vi^a&m 	^^_^_X_^_X_^X	1.0
Cedente turba; dirus exclamat Charon:	ce&de_nte^ tu_rba& di_ru^s e_xcla&ma&t cha^ro&n 	X_^_X_^_X_^X	1.0
'Quo pergis, audax? siste properantem gradum.'	qvo& pe_rgi^s [au]da&x si_ste^ pro^pe^ra&nte&m gra^du&m 	X_^_X_^^^X_^X	1.0
Non passus ullas natus Alcmena moras	no&n pa_ssu^s u_lla&s na_tu^s a_lcme&na_ mo^ra&s 	X_^_X_^_X_^X	1.0
Ipso coactum nauitam conto domat	i&pso_ co^a_ctu&m n[au]i^ta&m co&nto_ do^ma&t 	X_^_X_^_X_^X	1.0
Scanditque puppem. cumba populorum capax	sca&ndi_tqve^ pu_ppe&m cu_mba^ po^pu^lo&ru&m ca^pa&x 	X_^_X_^^^X_^X	1.0
Succubuit uni; sidit et grauior ratis	su&ccu^bu^i^t u_ni& si_di^t e&t gra^vi^o&r ra^ti&s 	X^^^_X_^_^^_^X	1.0
Vtrimque Lethen latere titubanti bibit.	u&tri_mqve^ le_the&n la^te^re^ ti^tu^ba&nti_ bi^bi&t 	X_^_X^^^^^X_^X	0.86
Tunc uicta trepidant monstra, Centauri truces	tu&nc vi_cta^ tre^pi^da&nt mo_nstra^ ce_nt[au]ri& tru^ce&s 	X_^^^X_^_X_^X	1.0
Lapithaeque multo in bella succensi mero;	la^pi^th[ae]qve^ mu_lto& i&n be_lla^ su_cce&nsi_ me^ro& 	^^_^_X_^_X_^X	1.0
Stygiae paludis ultimos quaerens sinus	sty^gi^[ae] pa^lu_di&s u_lti^mo&s qv[ae]re&ns si^nu&s 	^^_^_X_^_X_^X	1.0
Fecunda mergit capita Lernaeus labor.	fe&cu_nda^ me_rgi&t ca^pi^ta^ le_rn[ae]u&s la^bo&r 	X_^_X^^^_X_^X	0.97
Post haec auari Ditis apparet domus:	po&st h[ae]c a^va_ri& di_ti^s a_ppa&re&t do^mu&s 	X_^_X_^_X_^X	1.0
Hic saeuus umbras territat Stygius canis,	hi&c s[ae]vu^s u_mbra&s te_rri^ta&t sty^gi^u&s ca^ni&s 	X_^_X_^_^^_^X	0.4
Qui trina uasto capita concutiens sono	qvi& tri_na^ va_sto& ca^pi^ta^ co_ncu^ti^e&ns so^no& 	X_^_X^^^_^^_^X	1.0
Regnum tuetur. sordidum tabo caput	re&gnu&m tu^e_tu&r so_rdi^du&m ta&bo_ ca^pu&t 	X_^_X_^_X_^X	1.0
Lambunt colubrae, uiperis horrent iubae	la&mbu&nt co^lu_br[ae] vi_pe^ri_s ho&rre&nt ju^b[ae] 	X_^_X_^_X_^X	1.0
Longusque torta sibilat cauda draco.	lo&ngu_sqve^ to_rta& si_bi^la&t c[au]da_ dra^co& 	X_^_X_^_X_^X	1.0
Par ira formae: sensit ut motus pedum,	pa&r i_ra^ fo_rm[ae] se_nsi^t u&t mo&tu&s pe^du&m 	X_^_X_^_X_^X	1.0
Attollit hirtas angue uibrato comas	a&tto_lli^t hi_rta&s a_ngve^ vi_bra&to_ co^ma&s 	X_^_X_^_X_^X	1.0
Missumque captat aure subrecta sonum,	mi&ssu_mqve^ ca_pta&t [au]re^ su_bre&cta_ so^nu&m 	X_^_X_^_X_^X	1.0
Sentire et umbras solitus. ut propior stetit	se&nti_re& e^t u_mbra&s so^li^tu^s u&t pro^pi^o&r ste^ti&t 	X_^_X^^^_^^_^X	1.0
Ioue natus antro, sedit incertus canis	jo^ve^ na_tu^s a_ntro& se_di^t i_nce&rtu&s ca^ni&s 	^^_^_X_^_X_^X	0.4
Leuiterque timuit - ecce latratu graui	le^vi^te_rqve^ ti^mu^i&t e_cce^ la_tra&tu& gra^vi& 	^^_^^^X_^_X_^X	1.0
Loca muta terret; sibilat totos minax	lo^ca^ mu_ta^ te_rre&t si_bi^la&t to&to&s mi^na&x 	^^_^_X_^_X_^X	1.0
Serpens per armos. uocis horrendae fragor	se&rpe&ns pe^r a_rmo&s vo_ci^s ho_rre&nd[ae] fra^go&r 	X_^_X_^_X_^X	1.0
Per ora missus terna felices quoque	pe&r o_ra^ mi_ssu&s te_rna^ fe_li&ce&s qvo^qve& 	X_^_X_^_X_^X	0.93
Exterret umbras. soluit a laeua feros	e&xte_rre^t u_mbra&s so_lvi^t a_ l[ae]va_ fe^ro&s 	X_^_X_^_X_^X	1.0
Tunc ipse rictus et Cleonaeum caput	tu&nc i_pse^ ri_ctu&s e&t cle^o_n[ae]u_m ca^pu&t 	X_^_X_^_X_^X	1.0
Opponit ac se tegmine ingenti clepit,	o&ppo_ni^t a&c se& te_gmi^ne& i_nge&nti& cle^pi&t 	X_^_X_^_X_^X	1.0
Victrice magnum dextera robur gerens.	vi&ctri_ce^ ma_gnu&m de_xte^ra_ ro&bu&r ge^re&ns 	X_^_X_^_X_^X	1.0
Huc nunc et illuc uerbere assiduo rotat,	hu&c nu&nc e^t i_llu&c ve_rbe^re& a_ssi^du^o_ ro^ta&t 	X_^_X_^_^^_^X	1.0
Ingeminat ictus. domitus infregit minas	i&nge^mi^na^t i_ctu&s do^mi^tu^s i_nfre&gi&t mi^na&s 	X^^^_X^^^_X_^X	1.0
Et cuncta lassus capita summisit canis	e&t cu_ncta^ la_ssu&s ca^pi^ta^ su_mmi&si&t ca^ni&s 	X_^_X^^^_X_^X	0.4
Antroque toto cessit. extimuit sedens	a&ntro_qve^ to_to& ce_ssi^t e_xti^mu^i&t se^de&ns 	X_^_X_^_^^_^X	1.0
Vterque solio dominus et duci iubet;	u&te_rqve^ so^li^o& do^mi^nu^s e&t du&ci_ ju^be&t 	X_^^^X^^^_X_^X	1.0
Me quoque petenti munus Alcidae dedit.	me& qvo^qve^ pe^te_nti& mu_nu^s a_lci&d[ae] de^di&t 	X^^^_X_^_X_^X	0.93
Tum grauia monstri colla permulcens manu	tu&m gra^vi^a^ mo_nstri& co_lla^ pe_rmu&lce&ns ma^nu& 	X^^^_X_^_X_^X	1.0
Adamante texto uincit; oblitus sui	a^da^ma_nte^ te_xto& vi_nci^t o_bli&tu&s su^i& 	^^_^_X_^_X_^X	1.0
Custos opaci peruigil regni canis	cu&sto_s o^pa_ci& pe_rvi^gi&l re&gni_ ca^ni&s 	X_^_X_^_X_^X	0.4
Componit aures timidus et patiens trahi	co&mpo_ni^t [au]re&s ti^mi^du^s e&t pa^ti^e&ns tra^hi& 	X_^_X^^^_^^_^X	1.0
Erumque fassus, ore summisso obsequens,	e&ru_mqve^ fa_ssu&s o_re^ su_mmi&sso& o_bse^qve&ns 	X_^_X_^_X_^X	1.0
Vtrumque cauda pulsat anguifera latus.	u&tru_mqve^ c[au]da& pu_lsa^t a_ngvi^fe^ra_ la^tu&s	X_^_X_^_^^_^X	m
Postquam est ad oras Taenari uentum et nitor	po&stqva&m e&st a^d o_ra&s t[ae]na^ri_ ve&ntu&m e&t ni^to&r 	X_^_X_^_X_^X	0.57
Percussit oculos lucis ignotae, nouos	pe&rcu_ssi^t o^cu^lo&s lu_ci^s i_gno&t[ae] no^vo&s 	X_^^^X_^_X_^X	0.97
Resumit animos uictus et uastas furens	re&su_mi^t a^ni^mo&s vi_ctu^s e&t va&sta&s fu^re&ns 	X_^^^X_^_X_^X	0.92
Quassat catenas; paene uictorem abstulit	qva&ssa&t ca^te_na&s p[ae]ne^ vi_cto&re&m a_bstu^li&t 	X_^_X_^_X_^X	1.0
Pronumque retro uexit et mouit gradu.	pro&nu_mqve^ re_tro& ve_xi^t e&t mo&vi&t gra^du& 	X_^_X_^_X_^X	0.65
Tunc et meas respexit Alcides manus;	tu&nc e&t me^a&s re&spe_xi^t a_lci&de&s ma^nu&s 	X_^_X_^_X_^X	1.0
Geminis uterque uiribus tractum canem	ge^mi^ni_s u^te_rqve& vi_ri^bu&s tra&ctu&m ca^ne&m 	^^_^_X_^_X_^X	1.0
Ira furentem et bella temptantem inrita	i&ra_ fu^re_nte&m e&t be_lla^ te_mpta&nte&m i_nri^ta& 	X_^_X_^_X_^X	1.0
Intulimus orbi. uidit ut clarum diem	i&ntu^li^mu^s o_rbi& vi_di^t u&t cla&ru&m di^e&m 	X^^^_X_^_X_^X	1.0
Et pura nitidi spatia conspexit poli,	e&t pu_ra^ ni^ti^di& spa^ti^a^ co_nspe&xi&t po^li& 	X_^^^X^^^_X_^X	1.0
Oborta nox est, lumina in terram dedit	o&bo_rta^ no&x e&st lu_mi^na& i&n te&rra&m de^di&t 	X_^_X_^_X_^X	1.0
Compressit oculos et diem inuisum expulit	co&mpre_ssi^t o^cu^lo&s e&t di^e&m i_nvi&su&m e_xpu^li&t 	X_^^^X_^_X_^X	1.0
Aciemque retro flexit atque omni petit	a^ci^e_mqve^ re_tro& fle_xi^t a_tqve& o&mni_ pe^ti&t 	^^_^_X_^_X_^X	0.65
Ceruice terram; tum sub Herculeas caput	ce&rvi_ce^ te_rra&m tu&m su^b he_rcu^le^a&s ca^pu&t 	X_^_X_^_^^_^X	1.0
Abscondit umbras. Densa sed laeto uenit	a&bsco_ndi^t u_mbra&s de_nsa^ se&d l[ae]to_ ve^ni&t 	X_^_X_^_X_^X	0.57
Clamore turba frontibus laurum gerens	cla&mo_re^ tu_rba& fro_nti^bu&s l[au]ru&m ge^re&ns 	X_^_X_^_X_^X	1.0
Magnique meritas Herculis laudes canit.	ma&gni_qve^ me^ri^ta&s he_rcu^li&s l[au]de&s ca^ni&t 	X_^^^X_^_X_^X	1.0
Vltrice dextra fusus aduerso Lycus	u&ltri_ce^ de_xtra& fu_su^s a_dve&rso_ ly^cu&s 	X_^_X_^_X_^X	1.0
Terram cecidit ore; tum quisquis comes	te&rra&m ce^ci_di&t o_re^ tu&m qvi&sqvi&s co^me&s 	X_^_X_^_X_^X	0.03
Fuerat tyranni iacuit et poenae comes.	fu^e^ra&t ty^ra_nni& ja^cu^i^t e&t p[oe]n[ae] co^me&s 	^^_^_X^^^_X_^X	1.0
Nunc sacra patri uictor et superis feram	nu&nc sa_cra^ pa_tri& vi_cto^r e&t su^pe^ri&s fe^ra&m 	X_^_X_^_^^_^X	0.45
Caesisque meritas uictimis aras colam.	c[ae]si_sqve^ me^ri^ta&s vi_cti^mi_s a&ra&s co^la&m 	X_^^^X_^_X_^X	1.0
Te te laborum socia et adiutrix precor,	te& te_ la^bo_ru&m so^ci^a& e^t a_dju&tri_x pre^co&r 	X_^_X^^^_X_^X	1.0
Belligera Pallas, cuius in laeua ciet	be&lli^ge^ra^ pa_lla&s cu_ju^s i&n l[ae]va_ ci^e&t 	X^^^_X_^_X_^X	1.0
Aegis feroces ore saxifico minas;	[ae]gi&s fe^ro_ce&s o_re^ sa_xi^fi^co_ mi^na&s	X_^_X_^_^^_^X	m
Adsit Lycurgi domitor et rubri maris,	a_dsi&t ly^cu_rgi& do^mi^to^r e&t ru&bri_ ma^ri&s, 	X_^_X^^^_X_^X	m
Tectam uirente cuspidem thyrso gerens,	te&cta&m vi^re_nte& cu_spi^de&m thy&rso_ ge^re&ns 	X_^_X_^_X_^X	1.0
Geminumque numen Phoebus et Phoebi soror	ge^mi^nu_mqve^ nu_me&n ph[oe]bu^s e&t ph[oe]bi_ so^ro&r 	^^_^_X_^_X_^X	1.0
(Soror sagittis aptior, Phoebus lyrae)	so&ro&r sa^gi_tti&s a_pti^o&r ph[oe]bu&s ly^r[ae] 	X_^_X_^_X_^X	1.0
Fraterque quisquis incolit caelum meus	fra&te_rqve^ qvi_sqvi&s i_nco^li&t c[ae]lu&m me^u&s 	X_^_X_^_X_^X	1.0
Non ex nouerca frater. Huc appellite	no&n e&x no^ve_rca& fra_te^r hu_c a&ppe_lli^te& 	X_^_X_^_X_^X	1.0
Greges opimos, quidquid Indorum seges	gre&ge_s o^pi_mo&s qvi_dqvi^d i_ndo&ru&m se^ge&s 	X_^_X_^_X_^X	1.0
Arabesque odoris quidquid arboribus legunt	a^ra^be_sqve& o^do_ri&s qvi_dqvi^d a_rbo^ri^bu&s le^gu&nt 	^^_^_X_^_^^_^X	1.0
Conferte in aras, pinguis exundet uapor.	co&nfe_rte& i^n a_ra&s pi_ngvi^s e_xu&nde&t va^po&r 	X_^_X_^_X_^X	0.83
Populea nostras arbor exornet comas,	po&pu^le^a^ no_stra&s a_rbo^r e_xo&rne_t co^ma&s 	X^^^_X_^_X_^X	1.0
Te ramus oleae fronde gentili tegat,	te& ra_mu^s o^le^[ae] fro_nde^ ge_nti&li_ te^ga&t 	X_^^^X_^_X_^X	1.0
Theseu; Tonantem nostra adorabit manus,	the&s[eu] to^na_nte&m no_stra& a^do_ra&bi&t ma^nu&s 	X_^_X_^_X_^X	1.0
Tu conditores urbis et siluestria	tu& co_ndi^to_re&s u_rbi^s e&t si&lve_stri^a& 	X_^_X_^_X_^X	1.0
Trucis antra Zethi, nobilis Dircen aquae	tru^ci^s a_ntra^ ze_thi_, no_bi^li&s di_rce_n a^qu[ae] 	^^_^_X_^_X_^X	m
Laremque regis aduenae Tyrium coles.	la&re_mqve^ re_gi&s a_dve^nae_ ty^ri^u&m co^le&s 	X_^_X_^_^^_^X	0.99
Date tura flammis. Nate, manantes prius	da^te^ tu_ra^ fla_mmi&s na_te^ ma_na&nte&s pri^u&s 	^^_^_X_^_X_^X	1.0
Manus cruenta caede et hostili expia.	ma&nu&s cru^e_nta& c[ae]de& e^t ho_sti&li& e_xpi^a& 	X_^_X_^_X_^X	1.0
Vtinam cruore capitis inuisi deis	u^ti^na&m cru^o_re& ca^pi^ti^s i_nvi&si_ de^i&s 	^^_^_X^^^_X_^X	1.0
Libare possem: gratior nullus liquor	li&ba_re^ po_sse&m gra_ti^o&r nu&llu&s li^qvo&r 	X_^_X_^_X_^X	1.0
Tinxisset aras; uictima haut ulla amplior	ti&nxi_sse^t a_ra&s vi_cti^ma& h[au]t u&lla& a_mpli^o&r 	X_^_X_^_X_^X	1.0
Potest magisque opima mactari Ioui,	po&te&st ma^gi_sqve& o&pi_ma^ ma_cta&ri_ jo^vi& 	X_^_X_^_X_^X	1.0
Quam rex iniquus. Finiat genitor tuus	qva&m re&x i^ni_qvu&s fi_ni^a&t ge^ni^to&r tu^u&s 	X_^_X_^_^^_^X	1.0
Opta labores, detur aliquando otium	o&pta_ la^bo_re&s de_tu^r a^li^qva&ndo& o_ti^u&m 	X_^_X_^^^X_^X	1.0
Quiesque fessis. Ipse concipiam preces	qvi&e_sqve^ fe_ssi&s i_pse^ co_nci^pi^a&m pre^ce&s 	X_^_X_^_^^_^X	1.0
Ioue meque dignas: stet suo caelum loco	jo^ve^ me_qve^ di_gna&s ste&t su^o_ c[ae]lu&m lo^co& 	^^_^_X_^_X_^X	1.0
Tellusque et aether; astra inoffensos agant	te&llu_sqve& e^t [ae]the&r a_stra& i^no_ffe&nso_s a^ga&nt 	X_^_X_^_X_^X	1.0
Aeterna cursus, alta pax gentes alat;	[ae]te_rna^ cu_rsu&s a_lta^ pa&x ge&nte_s a^la&t 	X_^_X_^_X_^X	1.0
Ferrum omne teneat ruris innocui labor	fe&rru&m o_mne^ te^ne^a&t ru_ri^s i_nno&cui_ la^bo&r 	X_^^^X_^_X_^X	0.97
Ensesque lateant. nulla tempestas fretum	e&nse_sqve^ la^te^a&nt nu_lla^ te_mpe&sta&s fre^tu&m 	X_^^^X_^_X_^X	0.96
Violenta turbet, nullus irato Ioue	vi^o^le_nta^ tu_rbe&t nu_llu^s i_ra&to_ jo^ve& 	^^_^_X_^_X_^X	1.0
Exiliat ignis, nullus hiberna niue	e&xi^li^a^t i_gni&s nu_llu^s hi_be&rna_ ni^ve& 	X^^^_X_^_X_^X	1.0
Nutritus agros amnis euersos trahat.	nu&tri_tu^s a_gro&s a_mni^s [eu]e&rso&s tra^ha&t 	X_^_X_^_X_^X	0.87
Venena cessent, nulla nocituro grauis	ve&ne_na^ ce_sse&nt nu_lla^ no^ci^tu&ro& gra^vi&s	X_^_X_^^^X_^X	m
Suco tumescat herba. non saeui ac truces	su&co_ tu^me_sca&t he_rba^ no&n s[ae]vi& a&c tru^ce&s 	X_^_X_^_X_^X	1.0
Regnent tyranni; si quod etiamnum est scelus	re&gne&nt ty^ra_nni& si& qvo^d e^ti^a&mnu&m e&st sce^lu&s 	X_^_X_^^^X_^X	1.0
Latura tellus, properet, et si quod parat	la&tu_ra^ te_llu&s pro^pe^re^t e&t si& qvo&d pa^ra&t 	X_^_X^^^_X_^X	1.0
Monstrum, meum sit. - Sed quid hoc? medium diem	mo&nstru&m me^u&m si&t se&d qvi^d ho&c me^di^u&m di^e&m 	X_^_X_^_^^_^X	1.0
Cinxere tenebrae. Phoebus obscuro meat	ci&nxe_re^ te^ne^br[ae] ph[oe]bu^s o_bscu&ro_ me^a&t 	X_^^^X_^_X_^X	0.38
Sine nube uultu. quis diem retro fugat	si^ne^ nu_be^ vu_ltu& qvi&s di^e&m re&tro_ fu^ga&t 	^^_^_X_^_X_^X	1.0
Agitque in ortus? unde nox atrum caput	a&gi_tqve& i^n o_rtu&s u_nde^ no&x a&tru&m ca^pu&t 	X_^_X_^_X_^X	1.0
Ignota profert? unde tot stellae polum	i&gno_ta^ pro_fe&rt u_nde^ to&t ste&ll[ae] po^lu&m 	X_^_X_^_X_^X	1.0
Implent diurnae? primus en noster labor	i&mple&nt di^u_rnae& pri_mu^s e&n no&ste&r la^bo&r 	X_^_X_^_X_^X	0.96
Caeli refulget parte non minima leo	c[ae]li_ re^fu_lge&t pa_rte^ no&n mi^ni^ma_ le^o&	X_^_X_^_^^_^X	m
Iraque totus feruet et morsus parat.	i&ra_qve^ to_tu&s fe_rve^t e&t mo&rsu&s pa^ra&t 	X_^_X_^_X_^X	1.0
Iam rapiet aliquod sidus: ingenti minax	ja&m ra^pi^e^t a^li^qvo&d si_du^s i_nge&nti_ mi^na&x 	X^^^^^X_^_X_^X	1.0
Stat ore et ignes efflat et rutilam iubam	sta&t o_re& e^t i_gne&s e_ffla^t e&t ru^ti^la&m ju^ba&m	X_^_X_^_^^_^X	m
Ceruice iactans quidquid autumnus grauis	ce&rvi_ce^ ja_cta&ns qvi_dqvi^d [au]tu&mnu&s gra^vi&s 	X_^_X_^_X_^X	1.0
Hiemsque gelido frigida spatio refert	hi&e_msqve^ ge^li^do& fri_gi^da& spa^ti^o_ re^fe&rt 	X_^^^X_^_^^_^X	0.92
Vno impetu transiliet et uerni petet	u&no& i_mpe^tu& tra&nsi^li^e^t e&t ve&rni_ pe^te&t 	X_^_X^^^_X_^X	1.0
Frangetque tauri colla. Quod subitum hoc malum est?	fra&nge_tqve^ t[au]ri& co_lla^ qvo&d su^bi^tu&m ho&c ma^lu&m e&st 	X_^_X_^_^^_^X	0.72
Quo, nate, uultus huc et huc acres refers	qvo& na_te^ vu_ltu&s hu_c e^t hu_c a&cre&s re^fe&rs 	X_^_X_^_X_^X	1.0
Acieque falsum turbida caelum uides?	a^ci^e_qve^ fa_lsu&m tu_rbi^da_ c[ae]lu&m vi^de&s 	^^_^_X_^_X_^X	1.0
Perdomita tellus, tumida cesserunt freta,	pe&rdo^mi^ta^ te_llu&s tu^mi^da^ ce_sse&ru&nt fre^ta& 	X^^^_X^^^_X_^X	0.94
Inferna nostros regna sensere impetus:	i&nfe_rna^ no_stro&s re_gna^ se_nse&re& i_mpe^tu&s 	X_^_X_^_X_^X	1.0
Immune caelum est, dignus Alcide labor.	i&mmu_ne^ c[ae]lu&m e&st di_gnu^s a_lci&de_ la^bo&r 	X_^_X_^_X_^X	0.97
In alta mundi spatia sublimis ferar,	i&n a_lta^ mu_ndi& spa^ti^a^ su_bli&mi&s fe^ra&r 	X_^_X^^^_X_^X	1.0
Petatur aether: astra promittit pater.	pe&ta_tu^r [ae]the&r a_stra^ pro_mi&tti&t pa^te&r 	X_^_X_^_X_^X	1.0
Quid, si negaret? non capit terra Herculem	qvi&d si_ ne^ga_re&t no&n ca^pi&t te&rra& he_rcu^le&m 	X_^_X_^_X_^X	1.0
Tandemque superis reddit. en ultro uocat	ta&nde_mqve^ su^pe^ri&s re_ddi^t e_n u&ltro_ vo^ca&t 	X_^^^X_^_X_^X	1.0
Omnis deorum coetus et laxat fores,	o&mni&s de^o_ru&m c[oe]tu^s e&t la&xa&t fo^re&s 	X_^_X_^_X_^X	0.4
Vna uetante. recipis et reseras polum?	u&na_ ve^ta_nte& re^ci^pi^s e&t re^se^ra&s po^lu&m	X_^_X^^^_^^_^X	m
An contumacis ianuam mundi traho?	a&n co_ntu^ma_ci&s ja_nu^a_m mu&ndi& tra^ho& 	X_^_X_^_X_^X	1.0
Dubitatur etiam? uincla Saturno exuam	du^bi^ta_tu^r e^ti^a&m vi_ncla^ sa_tu&rno& e_xu^a&m	^^_^^^X_^_X_^X	m
Contraque patris impii regnum impotens	co&ntra_qve^ pa_tri&s i_mpi^i_ re&gnu&m i_mpo^te&ns 	X_^_X_^_X_^X	0.45
Auum resoluam; bella Titanes parent,	a&vu&m re^so_lva&m be_lla^ ti_ta&ne_s pa^re&nt 	X_^_X_^_X_^X	0.43
Me duce furentes; saxa cum siluis feram	me& du^ce^ fu^re_nte&s sa_xa^ cu&m si&lvi&s fe^ra&m 	X^^^_X_^_X_^X	1.0
Rapiamque dextra plena Centauris iuga.	ra^pi^a_mqve^ de_xtra& ple_na^ ce_nt[au]ri_s ju^ga& 	^^_^_X_^_X_^X	1.0
Iam monte gemino limitem ad superos agam:	ja&m mo_nte^ ge^mi^no& li_mi^te&m a&d su^pe^ro_s a^ga&m 	X_^^^X_^_^^_^X	1.0
Videat sub Ossa Pelion Chiron suum,	vi^de^a&t su^b o_ssa& pe_li^o&n chi&ro&n su^u&m 	^^_^_X_^_X_^X	1.0
In caelum Olympus tertio positus gradu	i&n c[ae]lu&m o^ly_mpu&s te_rti^o_ po^si^tu&s gra^du&	X_^_X_^_^^_^X	m
Perueniet aut mittetur. Infandos procul	pe&rve^ni^e^t [au]t mi&tte_tu^r i_nfa&ndo&s pro^cu&l 	X^^^_X_^_X_^X	0.38
Auerte sensus; pectoris sani parum	[au]e_rte^ se_nsu&s pe_cto^ri&s sa&ni_ pa^ru&m 	X_^_X_^_X_^X	1.0
Magni tamen compesce dementem impetum.	ma&gni_ ta^me&n co&mpe_sce^ de_me&nte&m i_mpe^tu&m 	X_^_X_^_X_^X	1.0
Quid hoc? Gigantes arma pestiferi mouent.	qvi&d ho&c gi^ga_nte&s a_rma^ pe_sti^fe^ri_ mo^ve&nt	X_^_X_^_^^_^X	m
Profugit umbras Tityos ac lacerum gerens	pro&fu_gi^t u_mbra&s ti^ty^o^s a&c la^ce^ru&m ge^re&ns	X_^_X^^^_^^_^X	v
Et inane pectus quam prope a caelo stetit.	e^t i^na_ne^ pe_ctu&s qva&m pro^pe& a_ c[ae]lo& ste^ti&t 	^^_^_X_^_X_^X	1.0
Labat Cithaeron, alta Pallene tremit	la&ba&t ci^th[ae]ro&n a_lta^ pa_lle&ne& tre^mi&t 	X_^_X_^_X_^X	1.0
Macetumque Tempe. rapuit hic Pindi iuga,	ma^ce^tu_mqve^ te_mpe& ra^pu^i^t hi&c pi&ndi_ ju^ga& 	^^_^_X^^^_X_^X	1.0
Hic rapuit Oeten, saeuit horrendum Mimans.	hi&c ra^pu^i^t [oe]te&n s[ae]vi^t ho_rre&ndu&m mi^ma&ns 	X^^^_X_^_X_^X	1.0
Flammifera Erinys uerbere excusso sonat	fla&mmi^fe^ra& e^ri_ny&s ve_rbe^re& e_xcu&sso_ so^na&t 	X^^^_X_^_X_^X	1.0
Rogisque adustas propius ac propius sudes	ro&gi_sqve& a^du_sta&s pro^pi^u^s a&c pro^pi^u&s su^de&s 	X_^_X^^^_^^_^X	1.0
In ora tendit; saeua Tisiphone, caput	i&n o_ra^ te_ndi&t s[ae]va^ ti_si^pho^ne_ ca^pu&t 	X_^_X_^_^^_^X	1.0
Serpentibus uallata, post raptum canem	se&rpe_nti^bu&s va&lla_ta^ po&st ra&ptu&m ca^ne&m 	X_^_X_^_X_^X	1.0
Portam uacantem clausit opposita face.	po&rta&m va^ca_nte&m cl[au]si^t o_ppo^si^ta_ fa^ce&	X_^_X_^_^^_^X	m
Sed ecce proles regis inimici latet,	se&d e_cce^ pro_le&s re_gi^s i^ni^mi&ci_ la^te&t 	X_^_X_^^^X_^X	0.99
Lyci nefandum semen: inuiso patri	ly&ci_ ne^fa_ndu&m se_me^n i_nvi&so_ pa^tri& 	X_^_X_^_X_^X	0.54
Haec dextra iam uos reddet. excutiat leuis	h[ae]c de_xtra^ ja&m vo&s re_dde^t e_xcu^ti^a&t le^vi&s	X_^_X_^_^^_^X	m
Neruus sagittas. tela sic mitti decet	ne&rvu&s sa^gi_tta&s te_la^ si&c mi&tti_ de^ce&t 	X_^_X_^_X_^X	1.0
Herculea. Quo se caecus impegit furor?	he&rcu^le^a^ qvo_ se& c[ae]cu^s i_mpe&gi&t fu^ro&r 	X^^^_X_^_X_^X	1.0
Vastum coactis flexit arcum cornibus	va&stu&m co^a_cti&s fle_xi^t a_rcu&m co_rni^bu&s 	X_^_X_^_X_^X	1.0
Pharetramque soluit, stridet emissa impetu	pha^re^tra_mqve^ so_lvi&t stri_de^t e_mi&ssa& i_mpe^tu& 	^^_^_X_^_X_^X	0.43
Harundo - medio spiculum collo fugit	ha&ru_ndo^ me^di^o& spi_cu^lu&m co&llo_ fu^gi&t 	X_^^^X_^_X_^X	0.76
Vulnere relicto. Ceteram prolem eruam	vu&lne^re^ re^li_cto& ce_te^ra_m pro&le&m e_ru^a&m 	X^^^_X_^_X_^X	1.0
Omnisque latebras. quid moror? maius mihi	o&mni_sqve^ la^te^bra&s qvi&d mo^ro&r ma&ju&s mi^hi& 	X_^^^X_^_X_^X	0.57
Bellum Mycenis restat, ut Cyclopia	be&llu&m my^ce_ni&s re_sta^t u&t cy&clo_pi^a& 	X_^_X_^_X_^X	1.0
Euersa manibus saxa nostris concidant.	[eu]e_rsa^ ma^ni^bu&s sa_xa^ no_stri&s co_nci^da&nt 	X_^^^X_^_X_^X	0.66
Huc eat et illuc claua disiecto obice	hu&c e^a^t e^t i_llu&c cl[au]a^ di_sje&cto& o_bi^ce& 	X^^^_X_^_X_^X	1.0
Rumpatque postes; columen impulsum labet. -	ru&mpa_tqve^ po_ste&s co^lu^me^n i_mpu&lsu&m la^be&t 	X_^_X^^^_X_^X	1.0
Perlucet omnis regia: hic uideo abditum	pe&rlu_ce^t o_mni&s re_gi^a& hi&c vi^de^o& a_bdi^tu&m 	X_^_X_^_^^_^X	1.0
Gnatum scelesti patris. En blandas manus	gna&tu_m sce^le_sti& pa_tri^s e&n bla&nda&s ma^nu&s 	X_^_X_^_X_^X	0.45
Ad genua tendens uoce miseranda rogat.	a&d ge^nu^a^ te_nde&ns uo_ce^ mi^se^ra_nda_ ro^ga&t.	X^^^_X_^^^X_^X	m
Scelus nefandum, triste et aspectu horridum:	sce&lu&s ne^fa_ndu&m tri_ste& e^t a_spe&ctu& ho_rri^du&m 	X_^_X_^_X_^X	1.0
Dextra precantem rapuit et circa furens	de&xtra_ pre^ca_nte&m ra^pu^i^t e&t ci&rca_ fu^re&ns 	X_^_X^^^_X_^X	1.0
Bis ter rotatum misit; ast illi caput	bi&s te&r ro^ta_tu&m mi_si^t a&st i&lli_ ca^pu&t 	X_^_X_^_X_^X	1.0
Sonuit, cerebro tecta disperso madent. -	so^nu^i&t ce^re_bro& te_cta^ di_spe&rso_ ma^de&nt 	^^_^_X_^_X_^X	0.88
At misera, paruum protegens gnatum sinu,	a&t mi^se^ra^ pa_rvu&m pro_te^ge_ns gna&tu_m si^nu& 	X^^^_X_^_X_^X	1.0
Megara furenti similis e latebris fugit.	me&ga^ra^ fu^re_nti& si^mi^li^s e_ la^te^bri&s fu^gi&t	X^^^_X^^^_^^_^X	m
Licet Tonantis profuga condaris sinu,	li&ce&t to^na_nti&s pro^fu^ga^ co_nda&ri&s si^nu& 	X_^_X^^^_X_^X	1.0
Petet undecumque temet haec dextra et feret.	pe^te^t u_nde^cu_mqve& te_me^t h[ae]c de&xtra& e&t fe^re&t 	^^_^_X_^_X_^X	1.0
Quo misera pergis? quam fugam aut latebras petis?	qvo& mi^se^ra^ pe_rgi&s qva&m fu^ga&m [au]t la^te^bra&s pe^ti&s 	X^^^_X_^_^^_^X	0.57
Nullus salutis Hercule infesto est locus.	nu&llu&s sa^lu_ti&s he_rcu^le& i_nfe&sto& e&st lo^cu&s 	X_^_X_^_X_^X	1.0
Amplectere ipsum potius et blanda prece	a&mple_cte^re& i_psu&m po^ti^u^s e&t bla&nda_ pre^ce& 	X_^_X^^^_X_^X	1.0
Lenire tempta. Parce iam, coniunx, precor,	le&ni_re^ te_mpta& pa_rce^ ja&m co&nju&nx pre^co&r 	X_^_X_^_X_^X	0.97
Agnosce Megaram. gnatus hic uultus tuos	a&gno_sce^ me^ga^ra&m gna_tu^s hi&c vu&ltu&s tu^o&s 	X_^^^X_^_X_^X	1.0
Habitusque reddit; cernis, ut tendat manus?	ha^bi^tu_sqve^ re_ddi&t ce_rni^s u&t te&nda&t ma^nu&s 	^^_^_X_^_X_^X	1.0
Teneo nouercam. sequere, da poenas mihi	te^ne^o_ no^ve_rca&m se^qve^re^ da_ p[oe]na&s mi^hi& 	^^_^_X^^^_X_^X	1.0
Iugoque pressum libera turpi Iouem;	ju&go_qve^ pre_ssu&m li_be^ra_ tu&rpi_ jo^ve&m 	X_^_X_^_X_^X	1.0
Sed ante matrem paruulum hoc monstrum occidat.	se&d a_nte^ ma_tre&m pa_rvu^lu&m ho&c mo&nstru&m o_cci^da&t 	X_^_X_^_X_^X	1.0
Quo tendis amens? sanguinem fundes tuum?	qvo& te_ndi^s a_me&ns sa_ngvi^ne&m fu&nde&s tu^u&m 	X_^_X_^_X_^X	1.0
Pauefactus infans igneo uultu patris	pa^ve^fa_ctu^s i_nfa&ns i_gne^o_ vu&ltu_ pa^tri&s 	^^_^_X_^_X_^X	0.55
Perit ante uulnus, spiritum eripuit pauor.	pe^ri^t a_nte^ vu_lnu&s spi_ri^tu&m e_ri^pu^i&t pa^vo&r 	^^_^_X_^_^^_^X	0.7
In coniugem nunc claua libratur grauis:	i&n co_nju^ge&m nu&nc cl[au]a^ li_bra&tu&r gra^vi&s 	X_^_X_^_X_^X	1.0
Perfregit ossa, corpori trunco caput	pe&rfre_gi^t o_ssa& co_rpo^ri& tru&nco_ ca^pu&t 	X_^_X_^_X_^X	1.0
Abest nec usquam est. cernere hoc audes, nimis	a&be&st ne^c u_sqva&m e&st ce_rne^re& ho_c [au]de&s ni^mi&s 	X_^_X_^_X_^X	1.0
Viuax senectus? si piget luctus, habes	vi&va&x se^ne_ctu&s si_ pi^ge&t lu&ctu_s ha^be&s 	X_^_X_^_X_^X	0.43
Mortem paratam - pectus en telo indue,	mo&rte&m pa^ra_ta&m pe_ctu^s e&n te&lo& i_ndu^e& 	X_^_X_^_X_^X	1.0
Vel stipitem istum huc caede monstrorum inlitum	ve&l sti_pi^te&m i_stu&m hu&c c[ae]de^ mo_nstro&ru&m i_nli^tu&m 	X_^_X_^_X_^X	1.0
Conuerte, falsum ac nomini turpem tuo	co&nve_rte^ fa_lsu&m a&c no_mi^ni_ tu&rpe&m tu^o& 	X_^_X_^_X_^X	1.0
Remoue parentem, ne tuae laudi obstrepat.	re^mo^ve_ pa^re_nte&m ne_ tu^[ae] l[au]di& o_bstre^pa&t 	^^_^_X_^_X_^X	1.0
Quo te ipse, senior, obuium morti ingeris?	qvo& te& i_pse^ se^ni^o&r o_bvi^u&m mo&rti& i_nge^ri&s 	X_^^^X_^_X_^X	1.0
Quo pergis amens? profuge et obtectus late	qvo& pe_rgi^s a_me&ns pro^fu^ge& e^t o_bte&ctu&s la^te& 	X_^_X^^^_X_^X	0.02
Vnumque manibus aufer Herculeis scelus.	u&nu_mqve^ ma^ni^bu&s [au]fe^r he_rcu^le^i&s sce^lu&s	X_^^^X_^_^^_^X	m
Bene habet, pudendi regis excisa est domus.	be^ne& ha^be&t pu^de_ndi& re_gi^s e_xci&sa& e&st do^mu&s 	^^_^_X_^_X_^X	0.99
Tibi hunc dicatum, maximi coniunx Iouis,	ti&bi& hu&nc di^ca_tu&m ma_xi^mi_ co&nju&nx jo^vi&s 	X_^_X_^_X_^X	1.0
Gregem cecidi; uota persolui libens	gre&ge&m ce^ci_di&&; uo_ta^ pe_rso_lui_ li^be&ns 	X_^_X_^_X_^X	m
Te digna, et Argos uictimas alias dabit.	te& di_gna& e^t a_rgo&s vi_cti^ma_s a^li^a&s da^bi&t	X_^_X_^_^^_^X	m
Nondum litasti, nate: consumma sacrum.	no&ndu&m li^ta_sti& na_te^ co_nsu&mma_ sa^cru&m 	X_^_X_^_X_^X	0.32
Stat ecce ad aras hostia, expectat manum	sta&t e_cce& a^d a_ra&s ho_sti^a& e_xpe&cta&t ma^nu&m 	X_^_X_^_X_^X	1.0
Ceruice prona; praebeo, occurro, insequor:	ce&rvi_ce^ pro_na& pr[ae]be^o& o_ccu&rro& i_nse^qvo&r 	X_^_X_^_X_^X	1.0
Macta - quid hoc est? errat acies luminum	ma&cta_ qvi^d ho_c e&st e_rra^t a^ci^e&s lu_mi^nu&m 	X_^_X_^^^X_^X	1.0
Visusque maeror hebetat? an uideo Herculis	vi&su_sqve^ m[ae]ro&r he^be^ta^t a&n vi^de^o& he_rcu^li&s 	X_^_X^^^_^^_^X	1.0
Manus trementes? uultus in somnum cadit	ma&nu&s tre^me_nte&s vu_ltu^s i&n so&mnu&m ca^di&t 	X_^_X_^_X_^X	0.35
Et fessa ceruix capite summisso labat;	e&t fe_ssa^ ce_rvi&x ca^pi^te^ su_mmi&sso_ la^ba&t 	X_^_X^^^_X_^X	1.0
Flexo genu iam totus ad terram ruit,	fle&xo_ ge^nu_ ja&m to_tu^s a&d te&rra&m ru^i&t 	X_^_X_^_X_^X	1.0
Vt caesa siluis ornus aut portum mari	u&t c[ae]sa^ si_lvi&s o_rnu^s [au]t po&rtu&m ma^ri& 	X_^_X_^_X_^X	1.0
Datura moles. uiuis an leto dedit	da&tu_ra^ mo_le&s vi_vi^s a&n le&to_ de^di&t 	X_^_X_^_X_^X	0.25
Idem tuos qui misit ad mortem furor?	i&de&m tu^o&s qvi& mi_si^t a&d mo&rte&m fu^ro&r 	X_^_X_^_X_^X	1.0
Sopor est: reciprocos spiritus motus agit.	so^po^r e&st re^ci^pro^co&s spi_ri^tu&s mo&tu_s a^gi&t 	^^_^^^X_^_X_^X	0.43
Detur quieti tempus, ut somno grauis	de&tu&r qvi^e_ti& te_mpu^s u&t so&mno& gra^vi&s 	X_^_X_^_X_^X	1.0
Vis uicta morbi pectus oppressum leuet. -	vi&s vi_cta^ mo_rbi& pe_ctu^s o_ppre&ssu&m le^ve&t 	X_^_X_^_X_^X	1.0
Remouete, famuli, tela, ne repetat furens.	re^mo^ve_te^ fa^mu^li& te_la^ ne_ re^pe^ta&t fu^re&ns 	^^_^^^X_^_^^_^X	1.0
Quis hic locus, quae regio, quae mundi plaga?	qui&s hi&c lo^cu&s, qu[ae] re^gi^o^, qu[ae] mu_ndi& pla^ga&? 	X_^_X^^^_X_^X	m
Vbi sum? sub ortu solis, an sub cardine	u^bi^ su&m su^b o_rtu& so_li^s a&n su&b ca_rdi^ne& 	^^_^_X_^_X_^X	0.86
Glacialis ursae? numquid Hesperii maris	gla^ci^a_li^s u_rs[ae] nu_mqvi^d he_spe^ri^i_ ma^ri&s 	^^_^_X_^_^^_^X	1.0
Extrema tellus hunc dat Oceano modum?	e&xtre_ma^ te_llu&s hu&nc da^t o_ce^a^no_ mo^du&m 	X_^_X_^_^^_^X	1.0
Quas trahimus auras? quod solum fesso subest?	qva&s tra^hi^mu^s [au]ra&s qvo&d so^lu&m fe&sso_ su^be&st 	X^^^_X_^_X_^X	0.37
Certe redimus - unde prostrata ad domum	ce&rte_ re^di_mu&s u_nde^ pro_stra&ta& a&d do^mu&m 	X_^_X_^_X_^X	1.0
Video cruenta corpora? an nondum exuit	vi^de^o& cru^e_nta& co_rpo^ra& a&n no&ndu&m e_xu^i&t 	^^_^_X_^_X_^X	1.0
Simulacra mens inferna? post reditus quoque	si^mu^la_cra^ me&ns i&nfe_rna^ po&st re^di^tu&s qvo^qve& 	^^_^_X_^_^^_^X	0.93
Oberrat oculis turba feralis meis?	o&be_rra^t o^cu^li&s tu_rba^ fe_ra&li&s me^i&s 	X_^^^X_^_X_^X	1.0
Pudet fateri: paueo; nescioquod mihi,	pu&de&t fa^te_ri& pa^ve^o^ ne_sci^o^qvo&d mi^hi&	X_^_X^^^_^^_^X	m
Nescioquod animus grande praesagit malum.	ne&sci^o^qvo^d a^ni^mu&s gra_nde^ pr[ae]sa&gi&t ma^lu&m 	X^^^^^X_^_X_^X	0.72
Vbi est parens? ubi illa natorum grege	u&bi& e&st pa^re&ns u&bi& i_lla^ na_to&ru&m gre^ge& 	X_^_X_^_X_^X	0.97
Animosa coniunx? cur latus laeuum uacat	a^ni^mo_sa^ co_nju&nx cu&r la^tu&s l[ae]vu&m va^ca&t 	^^_^_X_^_X_^X	0.98
Spolio leonis? quonam abit tegimen meum	spo^li^o_ le^o_ni&s qvo_na&m a^bi&t te^gi^me&n me^u&m 	^^_^_X_^_^^_^X	1.0
Idemque somno mollis Herculeo torus?	i&de_mqve^ so_mno& mo_lli^s he_rcu^le^o_ to^ru&s 	X_^_X_^_^^_^X	0.33
Vbi tela? ubi arcus? arma quis uiuo mihi	u^bi^ te_la& u^bi& a_rcu&s a_rma^ qvi&s vi&vo_ mi^hi& 	^^_^_X_^_X_^X	1.0
Detrahere potuit? spolia quis tanta abstulit	de&tra^he^re^ po^tu^i&t spo^li^a^ qvi&s ta&nta& a_bstu^li&t 	X^^^^^X^^^_X_^X	1.0
Ipsumque quis non Herculis somnum horruit?	i&psu_mqve^ qvi&s no&n he_rcu^li&s so&mnu&m ho_rru^i&t 	X_^_X_^_X_^X	1.0
Libet meum uidere uictorem, libet,	li&be&t me^u&m vi&de_re^ vi_cto&re&m li^be&t 	X_^_X_^_X_^X	1.0
Exurge, uirtus: quem nouum caelo pater	e&xu_rge^ vi_rtu&s qve&m no^vu&m c[ae]lo_ pa^te&r 	X_^_X_^_X_^X	1.0
Genuit relicto, cuius in fetu stetit	ge^nu^i&t re^li_cto& cu_ju^s i&n fe&tu& ste^ti&t	^^_^_X_^_X_^X	m
Nox longior quam nostra? - quod cerno nefas?	no&x lo_ngi^o&r qva&m no_stra^ qvo&d ce&rno_ ne^fa&s 	X_^_X_^_X_^X	0.8
Gnati cruenta caede confecti iacent,	gna&ti_ cru^e_nta& c[ae]de^ co_nfe&cti_ ja^ce&nt 	X_^_X_^_X_^X	1.0
Perempta coniunx. quis Lycus regnum obtinet?	pe&re_mpta^ co_nju&nx qvi&s ly^cu&s re&gnu&m o_bti^ne&t 	X_^_X_^_X_^X	1.0
Quis tanta Thebis scelera moliri ausus est	qvi&s ta_nta^ the_bi&s sce^le^ra^ mo_li&ri& [au]su^s e&st 	X_^_X^^^_X_^X	1.0
Hercule reuerso? quisquis Ismeni loca,	he&rcu^le^ re^ve_rso& qvi_sqvi^s i_sme&ni_ lo^ca& 	X^^^_X_^_X_^X	1.0
Actaea quisquis arua, qui gemino mari	a&ct[ae]a^ qvi_sqvi&s a_rva^ qvi_ ge^mi^no_ ma^ri& 	X_^_X_^_^^_^X	1.0
Pulsata Pelopis regna Dardanii colis,	pu&lsa_ta^ pe^lo^pi&s re_gna^ da_rda^ni^i_ co^li&s 	X_^^^X_^_^^_^X	1.0
Succurre, saeuae cladis auctorem indica.	su&ccu_rre^ s[ae]v[ae] cla_di^s [au]cto&re&m i_ndi^ca& 	X_^_X_^_X_^X	1.0
Ruat ira in omnis: hostis est quisquis mihi	ru^a^t i_ra& i^n o_mni&s ho_sti^s e&st qvi&sqvi&s mi^hi& 	^^_^_X_^_X_^X	0.93
Non monstrat hostem. uictor Alcidae, lates?	no&n mo_nstra^t ho_ste&m vi_cto^r a_lci&d[ae] la^te&s 	X_^_X_^_X_^X	1.0
Procede, seu tu uindicas currus truces	pro&ce_de^ s[eu] tu& vi_ndi^ca&s cu&rru&s tru^ce&s 	X_^_X_^_X_^X	1.0
Thracis cruenti siue Geryonae pecus	thra&ci&s cru^e_nti& si_ve^ ge_ry^o^n[ae] pe^cu&s 	X_^_X_^_^^_^X	1.0
Libyaeue dominos, nulla pugnandi mora est.	li^by^[ae]ve^ do^mi^no&s nu_lla^ pu_gna&ndi_ mo^ra& e&st 	^^_^^^X_^_X_^X	0.98
En nudus asto; uel meis armis licet	e&n nu_du^s a_sto& ve&l me^i_s a&rmi&s li^ce&t 	X_^_X_^_X_^X	1.0
Petas inermem. - cur meos Theseus fugit	pe&ta_s i^ne_rme&m cu&r me^o&s the&s[eu]s fu^gi&t 	X_^_X_^_X_^X	0.76
Paterque uultus? ora cur condunt sua?	pa&te_rqve^ vu_ltu&s o_ra^ cu&r co&ndu&nt su^a& 	X_^_X_^_X_^X	1.0
Differte fletus; quis meos dederit neci	di&ffe_rte^ fle_tu&s qvi&s me^o&s de^de^ri&t ne^ci& 	X_^_X_^_^^_^X	1.0
Omnis simul, profare. quid, genitor, siles?	o&mni&s si^mu&l pro&fa_re^ qvi&d ge^ni^to&r si^le&s 	X_^_X_^_^^_^X	1.0
At tu ede, Theseu, sed tua, Theseu, fide. -	a&t tu& e_de^ the_s[eu] se&d tu^a_ the&s[eu] fi^de& 	X_^_X_^_X_^X	0.97
Vterque tacitus ora pudibunda obtegit	u&te_rqve^ ta^ci^tu&s o_ra^ pu^di^bu&nda& o_bte^gi&t 	X_^^^X_^^^X_^X	1.0
Furtimque lacrimas fundit. in tantis malis	fu&rti_mqve^ la^cri^ma&s fu_ndi^t i&n ta&nti&s ma^li&s 	X_^^^X_^_X_^X	0.92
Quid est pudendum? numquid Argiuae impotens	qvi&d e&st pu^de_ndu&m nu_mqvi^d a_rgi&v[ae] i_mpo^te&ns 	X_^_X_^_X_^X	1.0
Dominator urbis, numquid infestum Lyci	do^mi^na_to^r u_rbi&s nu_mqvi^d i_nfe&stu&m ly^ci& 	^^_^_X_^_X_^X	1.0
Pereuntis agmen clade nos tanta obruit?	pe^re^u_nti^s a_gme&n cla_de^ no&s ta&nta& o_bru^i&t 	^^_^_X_^_X_^X	1.0
Per te meorum facinorum laudem precor,	pe&r te_ me^o_ru&m fa^ci^no^ru&m l[au]de&m pre^co&r 	X_^_X^^^_X_^X	1.0
Genitor, tuique nominis semper mihi	ge^ni^to&r tu^i_qve& no_mi^ni&s se&mpe&r mi^hi& 	^^_^_X_^_X_^X	1.0
Numen secundum, fare. quis fudit domum?	nu&me&n se^cu_ndu&m fa_re^ qvi&s fu&di&t do^mu&m 	X_^_X_^_X_^X	1.0
Cui praeda iacui? Tacita sic abeant mala.	cu&j pr[ae]da^ ja^cu^i& ta^ci^ta^ si_c a^be^a&nt ma^la& 	X_^^^X^^^_^^_^X	0.94
Vt inultus ego sim? Saepe uindicta obfuit.	u^t i^nu_ltu^s e^go^ si&m s[ae]pe^ vi_ndi&cta& o_bfu^i&t 	^^_^^^X_^_X_^X	1.0
Quisquamne segnis tanta tolerauit mala?	qvi&sqva_mne^ se_gni&s ta_nta^ to^le^ra&vi&t ma^la&	X_^_X_^^^X_^X	m
Maiora quisquis timuit. His etiam, pater,	ma&jo_ra^ qvi_sqvi&s ti^mu^i^t hi_s e^ti^a&m pa^te&r 	X_^_X^^^_^^_^X	1.0
Quicquam timeri maius aut grauius potest?	qvi&cqva&m ti^me_ri& ma_ju^s [au]t gra^vi^u&s po^te&st 	X_^_X_^_^^_^X	1.0
Cladis tuae pars ista quam nosti quota est!	cla&di&s tu^[ae] pa&rs i_sta^ qva&m no&sti& qvo^ta& e&st 	X_^_X_^_X_^X	1.0
Miserere, genitor, supplices tendo manus.	mi^se^re_re^ ge^ni^to&r su_ppli^ce&s te&ndo_ ma^nu&s 	^^_^^^X_^_X_^X	0.5
Quid hoc? manus refugit - hic errat scelus.	qvi&d ho&c ma^nu&s re&fu_gi^t hi_c e&rra&t sce^lu&s 	X_^_X_^_X_^X	0.84
Vnde hic cruor? quid illa puerili madens	u&nde& hi&c cru^o&r qvi&d i_lla^ pu^e^ri&li_ ma^de&ns 	X_^_X_^^^X_^X	1.0
Harundo leto? tincta Lernaea nece:	ha&ru_ndo^ le_to& ti_ncta^ le_rn[ae]a_ ne^ce& 	X_^_X_^_X_^X	1.0
Iam tela uideo nostra. non quaero manum:	ja&m te_la^ vi^de^o& no_stra^ no&n qv[ae]ro_ ma^nu&m 	X_^^^X_^_X_^X	0.5
Quis potuit arcum flectere aut quae dextera	qvi&s po^tu^i^t a_rcu&m fle_cte^re& [au]t qv[ae] de_xte^ra& 	X^^^_X_^_X_^X	1.0
Sinuare neruom uix recedentem mihi?	si^nu^a_re^ ne_rvo&m vi&x re^ce_de&nte&m mi^hi&	^^_^_X_^_X_^X	m
Ad uos reuertor; genitor, hoc nostrum est scelus?	a&d vo&s re^ve_rto&r ge^ni^to^r ho&c no&stru&m e&st sce^lu&s 	X_^_X^^^_X_^X	0.01
Tacuere: nostrum est. Luctus est istic tuus,	ta^cu^e_re^ no_stru&m e&st lu_ctu^s e&st i&sti&c tu^u&s 	^^_^_X_^_X_^X	0.57
Crimen nouercae: casus hic culpa caret.	cri&me&n no^ve_rc[ae] ca_su^s hi&c cu&lpa_ ca^re&t 	X_^_X_^_X_^X	0.39
Nunc parte ab omni, genitor, iratus tona;	nu&nc pa_rte& a^b o_mni& ge^ni^to^r i_ra&tu&s to^na& 	X_^_X^^^_X_^X	0.01
Oblite nostri, uindica sera manu	o&bli_te^ no_stri& vi_ndi^ca_ se&ra_ ma^nu& 	X_^_X_^_X_^X	1.0
Saltem nepotes. stelliger mundus sonet	sa&lte&m ne^po_te&s ste_lli^ge_r mu&ndu&s so^ne&t 	X_^_X_^_X_^X	1.0
Flammasque et hic et ille iaculetur polus;	fla&mma_sqve& e^t hi_c e&t i_lle^ ja^cu^le&tu&r po^lu&s 	X_^_X_^^^X_^X	0.99
Rupes ligatum Caspiae corpus trahant	ru&pe&s li^ga_tu&m ca_spi^[ae] co&rpu&s tra^ha&nt 	X_^_X_^_X_^X	1.0
Atque ales auida - cur Promethei uacant	a_tque& a_le^s a^ui^da& - cu&r pro^me_the&i_ ua^ca&nt 	X_^^^X_^_X_^X	m
Scopuli? paretur uertice immenso feras	sco^pu^li_ pa^re_tu&r ve_rti^ce& i_mme&nso_ fe^ra&s 	^^_^_X_^_X_^X	0.25
Volucresque pascens Caucasi abruptum latus	vo^lu^cre_sqve^ pa_sce&ns c[au]ca^si& a_bru&ptu&m la^tu&s 	^^_^_X_^_X_^X	0.58
Nudumque siluis. illa quae pontum Scythen	nu&du_mqve^ si_lvi&s i_lla^ qv[ae] po&ntu&m scy^the&n 	X_^_X_^_X_^X	1.0
Symplegas artat hinc et hinc uinctas manus	sy&mple_ga^s a_rta&t hi&nc e^t hi&nc vi&ncta&s ma^nu&s 	X_^_X_^_X_^X	1.0
Distendat alto, cumque reuocata uice	di&ste_nda^t a_lto& cu_mqve^ re^vo^ca&ta_ vi^ce& 	X_^_X_^^^X_^X	1.0
In se coibunt saxa et in caelum expriment	i&n se_ co^i_bu&nt sa_xa& e^t i&n c[ae]lu&m e_xpri^me&nt 	X_^_X_^_X_^X	m
Actis utrimque rupibus medium mare,	a&cti_s u^tri_mqve& ru_pi^bu&s me^di^u&m ma^re& 	X_^_X_^_^^_^X	1.0
Ego inquieta montium iaceam mora.	e&go& i_nqvi^e_ta& mo_nti^u&m ja^ce^a&m mo^ra& 	X_^_X_^_^^_^X	0.98
Quin structum aceruans nemore congesto aggerem	qvi&n stru_ctu&m a^ce_rva&ns ne^mo^re^ co_nge&sto& a_gge^re&m 	X_^_X^^^_X_^X	1.0
Cruore corpus impio sparsum cremo?	cru&o_re^ co_rpu&s i_mpi^o& spa&rsu&m cre^mo& 	X_^_X_^_X_^X	1.0
Sic, sic agendum est: inferis reddam Herculem.	si&c si_c a^ge_ndu&m e&st i_nfe^ri_s re&dda&m he_rcu^le&m 	X_^_X_^_X_^X	1.0
Nondum tumultu pectus attonito carens	no&ndu&m tu^mu_ltu& pe_ctu^s a_tto^ni^to_ ca^re&ns 	X_^_X_^_^^_^X	1.0
Mutauit iras, quodque habet proprium furor,	mu&t[au]i^t i_ra&s qvo_dqve& ha^be&t pro^pri^u&m fu^ro&r 	X_^_X_^_^^_^X	1.0
In se ipse saeuit. Dira Furiarum loca	i&n se& i_pse^ s[ae]vi&t di_ra^ fu^ri^a&ru&m lo^ca& 	X_^_X_^^^X_^X	1.0
Et inferorum carcer et sonti plaga	e&t i_nfe^ro_ru&m ca_rce^r e&t so&nti& pla^ga& 	X_^_X_^_X_^X	0.72
Decreta turbae - si quod exilium patet	de&cre_ta^ tu_rb[ae] si& qvo^d e_xi^li^u&m pa^te&t 	X_^_X_^_^^_^X	1.0
Vlterius Erebo, Cerbero ignotum et mihi,	u&lte^ri^u^s e^re^bo& ce_rbe^ro& i_gno&tu&m e&t mi^hi& 	X^^^^^X_^_X_^X	1.0
Hoc me abde, Tellus; Tartari ad finem ultimum	ho&c me& a_bde^ te_llu&s ta_rta^ri& a&d fi&ne&m u_lti^mu&m 	X_^_X_^_X_^X	1.0
Mansurus ibo. Pectus o nimium ferum!	ma&nsu_ru^s i_bo& pe_ctu^s o_ ni^mi^u&m fe^ru&m 	X_^_X_^_^^_^X	1.0
Quis uos per omnem, liberi, sparsos domum	qui_s uo&s pe^r o_mne&m, li_be^ri&, spa&rso&s do^mu&m 	X_^_X_^_X_^X	m
Deflere digne poterit? hic durus malis	de&fle_re^ di_gne& po^te^ri^t hi&c du&ru&s ma^li&s 	X_^_X^^^_X_^X	0.92
Lacrimare uultus nescit. huc arcum date,	la^cri^ma_re^ vu_ltu&s ne_sci^t hu_c a&rcu&m da^te& 	^^_^_X_^_X_^X	1.0
Date huc sagittas, stipitem huc uastum date.	da&te& hu&c sa^gi_tta&s sti_pi^te&m hu&c va&stu&m da^te& 	X_^_X_^_X_^X	1.0
Tibi tela frangam nostra, tibi nostros, puer,	ti^bi^ te_la^ fra_nga&m no_stra^ ti^bi^ no&stro&s pu^e&r 	^^_^_X_^^^X_^X	0.72
Rumpemus arcus; at tuis stipes grauis	ru&mpe_mu^s a_rcu&s a&t tu^i&s sti&pe&s gra^vi&s 	X_^_X_^_X_^X	1.0
Ardebit umbris; ipsa Lernaeis frequens	a&rde_bi^t u_mbri&s i_psa^ le_rn[ae]i&s fre^qve&ns 	X_^_X_^_X_^X	1.0
Pharetra telis in tuos ibit rogos:	pha&re_tra^ te_li&s i&n tu^o_s i&bi&t ro^go&s 	X_^_X_^_X_^X	0.62
Dent arma poenas. uos quoque infaustas meis	de&nt a_rma^ p[oe]na&s vo&s qvo^qve& i_nf[au]sta&s me^i&s 	X_^_X_^_X_^X	0.93
Cremabo telis, o nouercales manus.	cre&ma_bo^ te_li&s o_ no^ve_rca&le&s ma^nu&s 	X_^_X_^_X_^X	1.0
Quis nomen usquam sceleris errori addidit?	qvi&s no_me^n u_sqva&m sce^le^ri^s e_rro&ri& a_ddi^di&t 	X_^_X^^^_X_^X	1.0
Saepe error ingens sceleris obtinuit locum.	s[ae]pe& e_rro^r i_nge&ns sce^le^ri^s o_bti&n[ui]t lo^cu&m 	X_^_X^^^_X_^X	1.0
Nunc Hercule opus est: perfer hanc molem mali.	nu&nc he_rcu^le& o^pu^s e&st pe_rfe^r ha&nc mo&le&m ma^li& 	X_^^^X_^_X_^X	0.82
Non sic furore cessit extinctus pudor,	no&n si&c fu^ro_re& ce_ssi^t e_xti&nctu&s pu^do&r 	X_^_X_^_X_^X	1.0
Populos ut omnes impio aspectu fugem.	po^pu^lo_s u^t o_mne&s i_mpi^o& a_spe&ctu_ fu^ge&m 	^^_^_X_^_X_^X	1.0
Arma, arma, Theseu, flagito propere mihi	a&rma& a_rma^ the_s[eu] fla_gi^to& pro^pe^re_ mi^hi&	X_^_X_^_^^_^X	m
Subtracta reddi. sana si mens est mihi,	su&btra_cta^ re_ddi& sa_na^ si_ me&ns e&st mi^hi& 	X_^_X_^_X_^X	1.0
Referte manibus tela; si remanet furor,	re&fe_rte^ ma^ni^bu&s te_la^ si_ re^ma^ne&t fu^ro&r 	X_^^^X_^_^^_^X	0.66
Pater, recede: mortis inueniam uiam.	pa&te&r re^ce_de& mo_rti^s i_nve^ni^a&m vi^a&m 	X_^_X_^_^^_^X	0.97
Per sancta generis sacra, per ius nominis	pe&r sa_ncta^ ge^ne^ri&s sa_cra^ pe&r ju&s no_mi^ni&s 	X_^^^X_^_X_^X	0.97
Vtrumque nostri, siue me altorem uocas	u&tru_mqve^ no_stri& si_ve^ me& a_lto&re&m vo^ca&s 	X_^_X_^_X_^X	1.0
Seu tu parentem, perque uenerandos piis	s[eu] tu_ pa^re_nte&m pe_rqve^ ve^ne^ra&ndo&s pi^i&s 	X_^_X_^^^X_^X	1.0
Canos, senectae parce desertae, precor,	ca&no&s se^ne_ct[ae] pa_rce^ de_se&rt[ae] pre^co&r 	X_^_X_^_X_^X	0.97
Annisque fessis; unicum lapsae domus	a&nni_sqve^ fe_ssi&s u_ni^cu&m la&ps[ae] do^mu&s 	X_^_X_^_X_^X	1.0
Firmamen, unum lumen afflicto malis	fi&rma_me^n u_nu&m lu_me^n a_ffli&cto_ ma^li&s 	X_^_X_^_X_^X	0.92
Temet reserua. nullus ex te contigit	te&me&t re^se_rva& nu_llu^s e&x te& co_nti^gi&t 	X_^_X_^_X_^X	1.0
Fructus laborum; semper aut dubium mare	fru&ctu&s la^bo_ru&m se_mpe^r [au]t du^bi^u&m ma^re& 	X_^_X_^_^^_^X	1.0
Aut monstra timui; quisquis in toto furit	[au]t mo_nstra^ ti^mu^i& qvi_sqvi^s i&n to&to_ fu^ri&t 	X_^^^X_^_X_^X	1.0
Rex saeuus orbe, manibus aut aris nocens,	re&x s[ae]vu^s o_rbe& ma^ni^bu^s [au]t a&ri&s no^ce&ns 	X_^_X^^^_X_^X	0.66
A me timetur; semper absentis pater	a& me_ ti^me_tu&r se_mpe^r a_bse&nti&s pa^te&r 	X_^_X_^_X_^X	1.0
Fructum tui tactumque et aspectum peto.	fru&ctu&m tu^i_ ta&ctu_mqve& e^t a_spe&ctu&m pe^to& 	X_^_X_^_X_^X	1.0
Cur animam in ista luce detineam amplius	cu&r a^ni^ma&m i^n i_sta& lu_ce^ de_ti^ne^a&m a_mpli^u&s 	X^^^_X_^_^^_^X	1.0
Morerque nihil est: cuncta iam amisi bona,	mo&re_rqve^ ni^hi^l e&st cu_ncta^ ja&m a_mi&si_ bo^na& 	X_^^^X_^_X_^X	0.98
Mentem arma famam coniugem gnatos manus,	me&nte&m a_rma^ fa_ma&m co_nju^ge&m gna&to_s ma^nu&s 	X_^_X_^_X_^X	1.0
Etiam furorem. nemo polluto queat	e^ti^a&m fu^ro_re&m ne_mo^ po_llu&to& qve^a&t 	^^_^_X_^_X_^X	0.5
Animo mederi: morte sanandum est scelus.	a^ni^mo_ me^de_ri& mo_rte^ sa_na&ndu&m e&st sce^lu&s 	^^_^_X_^_X_^X	1.0
Perimes parentem? Facere ne possim, occidam.	pe^ri^me&s pa^re_nte&m fa^ce^re^ ne_ po&ssi&m o_cci^da&m 	^^_^_X^^^_X_^X	1.0
Genitore coram? Cernere hunc docui nefas.	ge^ni^to_re^ co_ra&m ce_rne^re& hu&nc do^cu^i_ ne^fa&s 	^^_^_X_^_^^_^X	1.0
Memoranda potius omnibus facta intuens	me^mo^ra_nda^ po^ti^u&s o_mni^bu&s fa&cta& i_ntu^e&ns 	^^_^^^X_^_X_^X	1.0
Vnius a te criminis ueniam pete.	u&ni_u^s a_ te& cri_mi^ni&s ve^ni^a&m pe^te&	X_^_X_^_^^_^X	m
Veniam dabit sibi ipse, qui nulli dedit?	ve^ni^a&m da^bi&t si&bi& i_pse^ qvi_ nu&lli_ de^di&t 	^^_^_X_^_X_^X	1.0
Laudanda feci iussus: hoc unum meum est.	l[au]da_nda^ fe_ci& ju_ssu^s ho_c u&nu&m me^u&m e&st 	X_^_X_^_X_^X	1.0
Succurre, genitor; siue te pietas mouet	su&ccu_rre^ ge^ni^to&r si_ve^ te_ pi^e^ta&s mo^ve&t 	X_^^^X_^_^^_^X	1.0
Seu triste factum siue uiolatum decus	s[eu] tri_ste^ fa_ctu&m si_ve^ vi^o^la&tu&m de^cu&s 	X_^_X_^^^X_^X	1.0
Virtutis, effer arma; uincatur mea	vi&rtu_ti^s e_ffe&r a_rma^ vi_nca&tu&r me^a& 	X_^_X_^_X_^X	1.0
Fortuna dextra. Sunt quidem patriae preces	fo&rtu_na^ de_xtra& su&nt qvi^de&m pa^tri^[ae] pre^ce&s 	X_^_X_^_^^_^X	1.0
Satis efficaces, sed tamen nostro quoque	sa^ti^s e_ffi^ca_ce&s se&d ta^me&n no&stro& qvo^qve& 	^^_^_X_^_X_^X	0.91
Mouere fletu. surge et aduersa impetu	mo&ve_re^ fle_tu& su_rge& e^t a_dve&rsa& i_mpe^tu& 	X_^_X_^_X_^X	1.0
Perfringe solito. nunc tuum nulli imparem	pe&rfri_nge^ so^li^to& nu&nc tu^u&m nu&lli& i_mpa^re&m 	X_^^^X_^_X_^X	1.0
Animum malo resume, nunc magna tibi	a^ni^mu&m ma^lo_ re&su_me^ nu&nc ma&gna_ ti^bi& 	^^_^_X_^_X_^X	0.5
Virtute agendum est: Herculem irasci ueta.	vi&rtu_te& a^ge_ndu&m e&st he_rcu^le&m i_ra&sci_ ve^ta& 	X_^_X_^_X_^X	1.0
Si uiuo, feci scelera; si morior, tuli.	si_ ui_uo^, fe_ci& sce^le^ra^; si_ mo^ri^o&r, tu^li&. 	X_^_X^^^_^^_^X	m
Purgare terras propero. iamdudum mihi	pu&rga_re^ te_rra&s pro^pe^ro^ ja_mdu&du&m mi^hi& 	X_^_X^^^_X_^X	1.0
Monstrum impium saeuumque et immite ac ferum	mo&nstru&m i_mpi^u&m s[ae]vu_mqve& e^t i_mmi&te& a&c fe^ru&m 	X_^_X_^_X_^X	1.0
Oberrat: agedum, dextra, conare aggredi	o&be_rra^t a^ge^du&m de_xtra^ co_na&re& a_ggre^di& 	X_^^^X_^_X_^X	1.0
Ingens opus, labore bis seno amplius.	i&nge&ns o^pu&s la&bo_re^ bi&s se&no& a_mpli^u&s 	X_^_X_^_X_^X	1.0
Ignaue, cessas, fortis in pueros modo	i&gn[au]e^ ce_ssa&s fo_rti^s i&n pu^e^ro&s mo^do& 	X_^_X_^_^^_^X	1.0
Pauidasque matres? arma nisi dantur mihi,	pa^vi^da_sqve^ ma_tre&s a_rma^ ni^si^ da&ntu&r mi^hi& 	^^_^_X_^^^X_^X	0.97
Altum omne Pindi Thracis excidam nemus	a&ltu&m o_mne^ pi_ndi& thra_ci^s e_xci&da&m ne^mu&s 	X_^_X_^_X_^X	1.0
Bacchique lucos et Cithaeronis iuga	ba&cchi_qve^ lu_co&s e&t ci^th[ae]ro&ni_s ju^ga& 	X_^_X_^_X_^X	1.0
Mecum cremabo, tota cum domibus suis	me&cu&m cre^ma_bo& to_ta^ cu&m do^mi^bu&s su^i&s 	X_^_X_^_^^_^X	1.0
Dominisque tecta, cum deis templa omnibus	do^mi^ni_sqve^ te_cta& cu&m de^i&s te&mpla& o_mni^bu&s 	^^_^_X_^_X_^X	1.0
Thebana supra corpus excipiam meum	the&ba_na^ su_pra& co_rpu^s e_xci^pi^a&m me^u&m 	X_^_X_^_^^_^X	0.88
Atque urbe uersa condar, et, si fortibus	a&tqve& u_rbe^ ve_rsa& co_nda^r e&t si& fo_rti^bu&s 	X_^_X_^_X_^X	0.98
Leue pondus umeris moenia immissa incident	le^ve^ po_ndu^s u^me^ri&s m[oe]ni^a& i_mmi&ssa& i_nci^de&nt 	^^_^^^X_^_X_^X	0.88
Septemque opertus non satis portis premar,	se&pte_mqve& o^pe_rtu&s no&n sa^ti&s po&rti&s pre^ma&r 	X_^_X_^_X_^X	1.0
Onus omne media parte quod mundi sedet	o^nu^s o_mne^ me^di^a& pa_rte^ qvo&d mu&ndi_ se^de&t 	^^_^^^X_^_X_^X	1.0
Dirimitque superos, in meum uertam caput.	di^ri^mi_tqve^ su^pe^ro&s i&n me^u&m ve&rta&m ca^pu&t 	^^_^^^X_^_X_^X	1.0
Reddo arma. Vox est digna genitore Herculis.	re&ddo& a_rma^ vo&x e&st di_gna^ ge^ni^to&re& he_rcu^li&s 	X_^_X_^^^X_^X	1.0
Hoc en peremptus spiculo cecidit puer.	ho&c e&n pe^re_mptu&s spi_cu^lo_ ce^ci^di&t pu^e&r	X_^_X_^_^^_^X	m
Hoc Iuno telum manibus emisit tuis.	ho&c ju_no^ te_lu&m ma^ni^bu^s e_mi&si&t tu^i&s 	X_^_X^^^_X_^X	0.31
Hoc nunc ego utar. Ecce quam miserum metu	ho&c nu&nc e^go& u_ta&r e_cce^ qva&m mi^se^ru&m me^tu& 	X_^_X_^_^^_^X	1.0
Cor palpitat pectusque sollicitum ferit.	co&r pa_lpi^ta&t pe&ctu_sqve^ so_lli^ci^tu&m fe^ri&t 	X_^_X_^_^^_^X	1.0
Aptata harundo est. Ecce iam facies scelus	a&pta_ta& ha^ru_ndo& e&st e_cce^ ja&m fa^ci^e&s sce^lu&s 	X_^_X_^_^^_^X	1.0
Volens sciensque. Pande, quid fieri iubes?	vo&le&ns sci^e_nsqve& pa_nde^ qvi&d fi^e^ri_ ju^be&s 	X_^_X_^_^^_^X	1.0
Nihil rogamus: noster in tuto est dolor.	ni&hi&l ro^ga_mu&s no_ste^r i&n tu&to& e&st do^lo&r 	X_^_X_^_X_^X	1.0
Natum potes seruare tu solus mihi,	na&tu&m po^te&s se&rva_re^ tu_ so&lu&s mi^hi& 	X_^_X_^_X_^X	1.0
Eripere nec tu; maximum euasi metum:	e&ri^pe^re^ ne&c tu& ma_xi^mu&m [eu]a&si_ me^tu&m 	X^^^_X_^_X_^X	1.0
Miserum haut potes me facere, felicem potes.	mi^se^ru&m h[au]t po^te&s me& fa^ce^re^ fe_li&ce&m po^te&s 	^^_^_X^^^_X_^X	1.0
Sic statue, quidquid statuis, ut causam tuam	si&c sta^tu^e^ qvi_dqvi&d sta^tu^i^s u&t c[au]sa&m tu^a&m 	X^^^_X^^^_X_^X	1.0
Famamque in arto stare et ancipiti scias:	fa&ma_mqve& i^n a_rto& sta_re& e^t a_nci^pi^ti& sci^a&s 	X_^_X_^_^^_^X	1.0
Aut uiuis aut occidis. hanc animam leuem	[au]t ui_ui^s [au]t o_cci_di^s. ha&nc a^ni^ma&m le^ue&m 	X_^_X_^_^^_^X	m
Fessamque senio nec minus fessam malis	fe&ssa_mqve^ se^ni^o& ne&c mi^nu&s fe&ssa&m ma^li&s 	X_^^^X_^_X_^X	0.92
In ore primo teneo. tam tarde patri	i&n o_re^ pri_mo& te^ne^o^. ta&m ta&rde_ pa^tri& 	X_^_X^^^_X_^X	m
Vitam dat aliquis? non feram ulterius moram,	vi&ta&m da^t a^li^qvi&s no&n fe^ra&m u_lte^ri^u&s mo^ra&m 	X_^^^X_^_^^_^X	1.0
Senile ferro pectus impresso induam:	se&ni_le^ fe_rro& pe_ctu^s i_mpre&sso& i_ndu^a&m 	X_^_X_^_X_^X	1.0
Hic, hic iacebit Herculis sani scelus.	hi&c hi&c ja^ce_bi&t he_rcu^li&s sa&ni_ sce^lu&s 	X_^_X_^_X_^X	1.0
Iam parce, genitor, parce, iam reuoca manum.	ja&m pa_rce^ ge^ni^to&r pa_rce^ ja&m re^vo^ca_ ma^nu&m	X_^^^X_^_^^_^X	m
Succumbe, uirtus, perfer imperium patris.	su&ccu_mbe^ vi_rtu&s pe_rfe^r i_mpe^ri^u&m pa^tri&s 	X_^_X_^_^^_^X	0.55
Eat ad labores hic quoque Herculeos labor:	e^a^t a&d la^bo_re&s hi&c qvo^qve& he_rcu^le^o&s la^bo&r	^^_^_X_^_^^_^X	m
Viuamus. artus alleua afflicti solo,	vi&va_mu^s a_rtu&s a_lle^va& a_ffli&cti_ so^lo& 	X_^_X_^_X_^X	0.71
Theseu, parentis. dextra contactus pios	the&s[eu] pa^re_nti&s de_xtra^ co_nta&ctu&s pi^o&s 	X_^_X_^_X_^X	1.0
Scelerata refugit. Hanc manum amplector libens,	sce^le^ra_ta^ re^fu^gi&t ha&nc ma^nu&m a_mple&cto&r li^be&ns 	^^_^^^X_^_X_^X	0.15
Hac nisus ibo, pectori hanc aegro admouens	ha&c ni_su^s i_bo& pe_cto^ri& ha&nc [ae]gro& a_dmo^ve&ns 	X_^_X_^_X_^X	0.89
Pellam dolores. Quem locum profugus petam?	pe&lla&m do^lo_re&s qve&m lo^cu&m pro^fu^gu&s pe^ta&m 	X_^_X_^_^^_^X	1.0
Vbi me recondam quaue tellure obruar?	u^bi^ me_ re^co_nda&m qv[au]e^ te_llu&re& o_bru^a&r 	^^_^_X_^_X_^X	1.0
Quis Tanais aut quis Nilus aut quis Persica	qvi&s ta^na^i^s [au]t qvi&s ni_lu^s [au]t qvi&s pe_rsi^ca& 	X^^^_X_^_X_^X	1.0
Violentus unda Tigris aut Rhenus ferox	vi^o^le_ntu^s u_nda& ti_gri^s [au]t rhe&nu&s fe^ro&x 	^^_^_X_^_X_^X	1.0
Tagusue Hibera turbidus gaza fluens	ta&gu_sve& hi^be_ra& tu_rbi^du&s ga&za_ flu^e&ns 	X_^_X_^_X_^X	1.0
Abluere dextram poterit? Arctoum licet	a&blu^e^re^ de_xtra&m po^te^ri^t a_rcto&u&m li^ce&t 	X^^^_X^^^_X_^X	1.0
Maeotis in me gelida transfundat mare	m[ae]o_ti^s i&n me& ge^li^da^ tra_nsfu&nda&t ma^re& 	X_^_X^^^_X_^X	1.0
Et tota Tethys per meas currat manus,	e&t to_ta^ te_thy&s pe&r me^a&s cu&rra&t ma^nu&s 	X_^_X_^_X_^X	1.0
Haerebit altum facinus. in quas impius	h[ae]re_bi^t a_ltu&m fa^ci^nu^s i&n qva&s i_mpi^u&s 	X_^_X^^^_X_^X	1.0
Terras recedes? ortum an occasum petes?	te&rra&s re^ce_de&s o_rtu&m a^n o_cca&su&m pe^te&s 	X_^_X_^_X_^X	1.0
Vbique notus perdidi exilio locum.	u&bi_qve^ no_tu&s pe_rdi^di& e_xi^li^o_ lo^cu&m 	X_^_X_^_^^_^X	0.0
Me refugit orbis, astra transuersos agunt	me& re^fu^gi^t o_rbi&s a_stra^ tra_nsve&rso_s a^gu&nt 	X^^^_X_^_X_^X	0.15
Obliqua cursus, ipse Titan Cerberum	o&bli_qva^ cu_rsu&s i_pse^ ti_ta&n ce_rbe^ru&m 	X_^_X_^_X_^X	1.0
Meliore uultu uidit. O fidum caput,	me^li^o_re^ vu_ltu& vi_di^t o_ fi&du&m ca^pu&t 	^^_^_X_^_X_^X	1.0
Theseu, latebram quaere longinquam, abditam;	the&s[eu], la^te_bra&m qu[ae]re^ lo_ngi_nqua&m, a_bdi^ta&m; 	X_^_X_^_X_^X	m
Quoniamque semper sceleris alieni arbiter	qvo^ni^a_mqve^ se_mpe&r sce^le^ri^s a^li^e&ni& a_rbi^te&r 	^^_^_X^^^^^X_^X	1.0
Amas nocentes, gratiam meritis refer	a&ma&s no^ce_nte&s gra_ti^a&m me^ri^ti&s re^fe&r 	X_^_X_^_^^_^X	1.0
Vicemque nostris: redde me infernis, precor,	vi&ce_mqve^ no_stri&s re_dde^ me& i_nfe&rni&s pre^co&r 	X_^_X_^_X_^X	1.0
Vmbris reductum, meque subiectum tuis	u&mbri&s re^du_ctu&m me_qve^ su_bje&ctu&m tu^i&s 	X_^_X_^_X_^X	1.0
Restitue uinclis: ille me abscondet locus -	re&sti^tu^e^ vi_ncli&s i_lle^ me& a_bsco&nde&t lo^cu&s 	X^^^_X_^_X_^X	1.0
Sed et ille nouit. Nostra te tellus manet.	se^d e^t i_lle^ no_vi&t no_stra^ te_ te&llu&s ma^ne&t 	^^_^_X_^_X_^X	0.98
Illic solutam caede Gradiuus manum	i&lli&c so^lu_ta&m c[ae]de^ gra_di&vu&s ma^nu&m 	X_^_X_^_X_^X	1.0
Restituit armis: illa te, Alcide, uocat,	re&sti^tu^i^t a_rmi&s i_lla^ te& a_lci&de_ vo^ca&t 	X^^^_X_^_X_^X	1.0
Facere innocentes terra quae superos solet.	fa^ce^re& i_nno^ce_nte&s te_rra^ qv[ae] su^pe^ro&s so^le&t 	^^_^_X_^_^^_^X	1.0
