/*
Created by Aleksandr Fedchin on 1/1/2019.
This is the complete scansion of trimeter sections of Seneca's Hercules Oetaeus
The edition used is that of O. Zwierlein, 1986, source:mqdq.it
MqDq version was modified whenever there were typos (lines 1171, 1784).
Estimated accuracy: 98%

Each line contains a verse from the original text, a list of words from that
verse with their inferred scansions, the scansion itself, and one of the
following tags:
    'm' - if the line was manually scanned
    'v' - if automatically produced scansion was manually verified
    'c' - if automatically produced scansion was corrected
    'u' - if the line was left unscanned
    confidence score that the program assigns to the line (higher=better)

Key:
X - monosyllabic anceps (can also be marked as _ or ^ wherever the line is
	scanned manually)
_ - long syllable
^ - short syllable
& - the quantity is unknown (for elided syllables, anceps syllables,
	or syllables long by position)
Resolution rate: 0.715
Resolution rate in lines in which speakers remain the same: 0.714
Resolution rate in lines in which speakers change: 0.75
*/

Sator deorum, cuius excussum manu	sa&to&r de^o_ru&m cu_ju^s e_xcu&ssu&m ma^nu& 	X_^_X_^_X_^X	1.0
Vtraeque Phoebi sentiunt fulmen domus,	u&tr[ae]qve^ ph[oe]bi& se_nti^u_nt fu&lme&n do^mu&s 	X_^_X_^_X_^X	1.0
Secure regna: protuli pacem tibi,	se&cu_re^ re_gna& pro_tu^li_ pa&ce&m ti^bi& 	X_^_X_^_X_^X	1.0
Quacumque Nereus porrigi terras uetat.	qva&cu_mqve^ ne_r[eu]s po_rri^gi_ te&rra&s ve^ta&t 	X_^_X_^_X_^X	1.0
Non est tonandum; perfidi reges iacent,	no&n e&st to^na_ndu&m pe_rfi^di_ re&ge&s ja^ce&nt 	X_^_X_^_X_^X	1.0
Saeui tyranni. fregimus quidquid fuit	s[ae]vi_ ty^ra_nni& fre_gi^mu&s qvi&dqvi&d fu^i&t 	X_^_X_^_X_^X	1.0
Tibi fulminandum. sed mihi caelum, parens,	ti^bi^ fu_lmi^na_ndu&m se&d mi^hi_ c[ae]lu&m pa^re&ns 	^^_^_X_^_X_^X	0.16
Adhuc negatur? parui certe Ioue	a&dhu&c ne^ga_tu&r? pa_ru^i_ ce_rte_ io^ue& 	X_^_X_^_X_^X	m
Vbique dignus teque testata est meum	u&bi_qve^ di_gnu&s te_qve^ te_sta&ta& e&st me^u&m 	X_^_X_^_X_^X	1.0
Patrem nouerca. quid tamen nectis moras?	pa&tre&m no^ve_rca& qvi&d ta^me&n ne&cti&s mo^ra&s 	X_^_X_^_X_^X	1.0
Numquid timemur? numquid impositum sibi	nu&mqvi&d ti^me_mu&r nu_mqvi^d i_mpo^si^tu&m si^bi& 	X_^_X_^_^^_^X	1.0
Non poterit Atlas ferre cum caelo Herculem?	no&n po^te^ri^t a_tla&s fe_rre^ cu&m c[ae]lo& he_rcu^le&m 	X^^^_X_^_X_^X	0.79
Quid astra, genitor, quid negas? mors me tibi	qvi&d a_stra^ ge^ni^to&r qvi&d ne^ga&s mo&rs me_ ti^bi& 	X_^^^X_^_X_^X	1.0
Certe remisit, omne concessit malum	ce&rte_ re^mi_si&t o_mne^ co_nce&ssi&t ma^lu&m 	X_^_X_^_X_^X	0.72
Quod terra genuit, pontus aer inferi:	qvo&d te_rra^ ge^nu^i&t po_ntu^s a_e&r i_nfe^ri& 	X_^^^X_^_X_^X	1.0
Nullus per urbes errat Argolicas leo,	nu&llu&s pe^r u_rbe&s e_rra^t a_rgo^li^ca&s le^o& 	X_^_X_^_^^_^X	1.0
Stymphalis icta est, Maenali nulla est fera;	sty&mpha_li^s i_cta& e&st m[ae]na^li_ nu&lla& e&st fe^ra& 	X_^_X_^_X_^X	1.0
Sparsit peremptus aureum serpens nemus	spa&rsi&t pe^re_mptu&s [au]re^u&m se&rpe&ns ne^mu&s 	X_^_X_^_X_^X	0.98
Et hydra uires posuit et notos Hebro	e&t hy_dra^ ui_re&s po^su^i^t e&t no&to&s he^bro_ 	X_^_X^^^_X_^X	m
Cruore pingues hospitum fregi greges	cru&o_re^ pi_ngve&s ho_spi^tu&m fre&gi& gre^ge&s 	X_^_X_^_X_^X	1.0
Hostique traxi spolia Thermodontiae.	ho&sti_qve^ tra_xi& spo^li^a^ the_rmo&do_nti^[ae] 	X_^_X^^^_X_^X	1.0
Vici regentem fata nec tantum redi,	vi&ci_ re^ge_nte&m fa_ta^ ne&c ta&ntu&m re^di& 	X_^_X_^_X_^X	1.0
Sed trepidus atrum Cerberum uidit dies	se&d tre^pi^du^s a_tru&m ce_rbe^ru_m vi&di&t di^e&s 	X^^^_X_^_X_^X	1.0
Et ille solem. nullus Antaeus Libys	e&t i_lle^ so_le&m nu_llu^s a_nt[ae]u&s li^by&s 	X_^_X_^_X_^X	1.0
Animam resumit, cecidit ante aras suas	a^ni^ma&m re^su_mi&t ce^ci^di^t a_nte& a&ra&s su^a&s 	^^_^_X^^^_X_^X	0.97
Busiris, una Geryon sparsus manu	bu&si_ri^s u_na& ge_ry^o_n spa&rsu&s ma^nu& 	X_^_X_^_X_^X	1.0
Taurusque populis horridus centum pauor.	t[au]ru_sqve^ po^pu^li&s ho_rri^du&s ce&ntu&m pa^vo&r 	X_^^^X_^_X_^X	1.0
Quodcumque tellus genuit infesta occidit	qvo&dcu_mqve^ te_llu&s ge^nu^i^t i_nfe&sta& o_cci^di&t 	X_^_X^^^_X_^X	1.0
Meaque fusum est dextera: iratis deis	me^a_que^ fu_su&m e&st de_xte^ra&: i_ra&ti&s de^i&s 	X_^_X_^_X_^X	m
Non licuit esse. si negat mundus feras,	no&n li^cu^i^t e_sse& si_ ne^ga&t mu&ndu&s fe^ra&s 	X^^^_X_^_X_^X	1.0
Animum nouerca, redde nunc nato patrem	a^ni^mu&m no^ve_rca& re_dde^ nu&nc na&to_ pa^tre&m 	^^_^_X_^_X_^X	0.71
Vel astra forti. nec peto ut monstres iter;	ve&l a_stra^ fo_rti& ne&c pe^to& u&t mo&nstre_s i^te&r 	X_^_X_^_X_^X	1.0
Permitte tantum, genitor: inueniam uiam.	pe&rmi_tte^ ta_ntu&m ge^ni^to^r i_nve^ni^a&m vi^a&m 	X_^_X^^^_^^_^X	0.01
Vel si times ne terra concipiat feras,	ve&l si_ ti^me&s ne& te_rra^ co_nci^pi^a&t fe^ra&s 	X_^_X_^_^^_^X	1.0
Properet malum quodcumque, dum terra Herculem	pro^pe^re&t ma^lu&m qvo&dcu_mqve^ du&m te&rra& he_rcu^le&m 	^^_^_X_^_X_^X	0.72
Habet uidetque: nam quis inuadet mala	ha&be&t vi^de_tqve& na&m qvi^s i_nva&de&t ma^la& 	X_^_X_^_X_^X	0.71
Aut quis per urbes rursus Argolicas erit	[au]t qvi&s pe^r u_rbe&s ru_rsu^s a_rgo^li^ca_s e^ri&t 	X_^_X_^_^^_^X	1.0
Iunonis odio dignus? in tutum meas	ju&no_ni^s o^di^o& di_gnu^s i&n tu&tu&m me^a&s 	X_^^^X_^_X_^X	1.0
Laudes redegi, nulla me tellus silet:	l[au]de&s re^de_gi& nu_lla^ me_ te&llu&s si^le&t 	X_^_X_^_X_^X	1.0
Me sensit ursae frigidum Scythicae genus	me& se_nsi^t u_rs[ae] fri_gi^du&m scy^thi^c[ae] ge^nu&s 	X_^_X_^_^^_^X	1.0
Indusque Phoebo subditus, cancro Libys;	i&ndu_sqve^ ph[oe]bo& su_bdi^tu&s ca&ncro_ li^by&s 	X_^_X_^_X_^X	1.0
Te, clare Titan, testor: occurri tibi	te& cla_re^ ti_ta&n te_sto^r o_ccu&rri_ ti^bi& 	X_^_X_^_X_^X	0.5
Quacumque fulges, nec meos lux prosequi	qva&cu_mqve^ fu_lge&s ne&c me^o&s lu&x pro_se^qvi& 	X_^_X_^_X_^X	1.0
Potuit triumphos, solis excessi uices	po^tu^i&t tri^u_mpho&s so_li^s e_xce&ssi_ vi^ce&s 	^^_^_X_^_X_^X	0.86
Intraque nostras substitit metas dies.	i&ntra_qve^ no_stra&s su_bsti^ti&t me&ta&s di^e&s 	X_^_X_^_X_^X	1.0
Natura cessit, terra defecit gradum:	na&tu_ra^ ce_ssi&t te_rra^ de_fe&ci&t gra^du&m 	X_^_X_^_X_^X	1.0
Lassata prior est. nox et extremum chaos	la&ssa_ta^ pri^o^r e&st no&x e^t e_xtre&mu&m cha^o&s 	X_^^^X_^_X_^X	1.0
In me incucurrit: inde ad hunc orbem redi,	i&n me& i_ncu^cu_rri&t i_nde& a^d hu&nc o&rbe&m re^di& 	X_^_X_^_X_^X	1.0
Nemo unde retro est. tulimus Oceani minas,	ne&mo& u_nde^ re_tro& e&st tu^li^mu^s o_ce^a^ni_ mi^na&s 	X_^_X^^^_^^_^X	0.65
Nec ulla ualuit quatere tempestas ratem	ne&c u_lla^ va^lu^i&t qva^te^re^ te_mpe&sta&s ra^te&m 	X_^^^X^^^_X_^X	1.0
Quamcumque pressi - pars quota est Perseus mei?	qva&mcu_mqve^ pre_ssi& pa&rs qvo^ta& e&st pe&rs[eu]s me^i& 	X_^_X_^_X_^X	1.0
Iam uacuus aether non potest odio tuae	ja&m va^cu^u^s [ae]the&r no&n po^te&st o^di^o_ tu^[ae] 	X^^^_X_^_^^_^X	1.0
Sufficere nuptae quasque deuincam feras	su&ffi^ce^re^ nu_pt[ae] qva_sqve^ d[eu]i&nca&m fe^ra&s 	X^^^_X_^_X_^X	1.0
Tellus timet concipere nec monstra inuenit.	te&llu&s ti^me&t co&nci^pe^re^ ne&c mo&nstra& i_nve^ni&t 	X_^_X^^^_X_^X	0.65
Ferae negantur: Hercules monstri loco	fe&r[ae] ne^ga_ntu&r he_rcu^le&s mo&nstri_ lo^co& 	X_^_X_^_X_^X	1.0
Iam coepit esse; quanta non fregi mala,	ja&m c[oe]pi^t e_sse& qva_nta^ no&n fre&gi_ ma^la& 	X_^_X_^_X_^X	0.94
Quot scelera nudus? quidquid immane obstitit,	qvo&t sce^le^ra^ nu_du&s qvi_dqvi^d i_mma&ne& o_bsti^ti&t 	X^^^_X_^_X_^X	1.0
Solae manus strauere; nec iuuenis feras	so&l[ae] ma^nu&s str[au]e_re^ ne&c ju^ve^ni&s fe^ra&s 	X_^_X_^_^^_^X	1.0
Timui nec infans. quidquid est iussum leue est,	ti^mu^i_ ne^c i_nfa&ns qvi_dqvi^d e&st ju&ssu&m le^ve& e&st 	^^_^_X_^_X_^X	0.92
Nec ulla nobis segnis illuxit dies.	ne&c u_lla^ no_bi&s se_gni^s i_llu&xi_t di^e&s 	X_^_X_^_X_^X	1.0
O quanta fudi monstra quae nullus mihi	o& qva_nta^ fu_di& mo_nstra^ qv[ae] nu&llu&s mi^hi& 	X_^_X_^_X_^X	1.0
Rex imperauit! institit uirtus mihi	re&x i_mpe^ra_vi&t i_nsti^ti&t vi&rtu&s mi^hi& 	X_^_X_^_X_^X	1.0
Iunone peior. Sed quid inpauidum genus	ju&no_ne^ p[ei]o&r se&d qvi^d i_npa^vi^du&m ge^nu&s 	X_^_X_^_^^_^X	1.0
Fecisse prodest? non habent pacem dei:	fe&ci_sse^ pro_de&st no_n ha^be&nt pa&ce&m de^i& 	X_^_X_^_X_^X	1.0
Purgata tellus omnis in caelo uidet	pu&rga_ta^ te_llu&s o_mni^s i&n c[ae]lo_ vi^de&t 	X_^_X_^_X_^X	0.87
Quodcumque timuit: transtulit Iuno feras.	qvo&dcu_mqve^ ti^mu^i&t tra_nstu^li&t ju&no_ fe^ra&s 	X_^^^X_^_X_^X	0.53
Ambit peremptus cancer ardentem plagam	a&mbi&t pe^re_mptu&s ca_nce^r a_rde&nte&m pla^ga&m 	X_^_X_^_X_^X	0.5
Libyaeque sidus fertur et messes alit;	li^by^[ae]qve^ si_du&s fe_rtu^r e&t me&sse_s a^li&t 	^^_^_X_^_X_^X	1.0
Annum fugacem tradit Astraeae leo,	a&nnu&m fu^ga_ce&m tra_di^t a_str[ae][ae] le^o& 	X_^_X_^_X_^X	1.0
At ille, iactans feruidam collo iubam,	a&t i_lle^ ja_cta&ns fe_rvi^da_m co&llo_ ju^ba&m 	X_^_X_^_X_^X	1.0
Austrum madentem siccat et nimbos rapit.	[au]stru&m ma^de_nte&m si_cca^t e&t ni&mbo&s ra^pi&t 	X_^_X_^_X_^X	1.0
Inuasit omnis ecce iam caelum fera	i&nva_si^t o_mni&s e_cce^ ja&m c[ae]lu&m fe^ra& 	X_^_X_^_X_^X	1.0
Meque antecessit: uictor e terris meos	me&qve& a_nte^ce_ssi&t vi_cto^r e_ te&rri&s me^o&s 	X_^_X_^_X_^X	1.0
Specto labores, astra portentis prius	spe&cto_ la^bo_re&s a_stra^ po_rte&nti_s pri^u&s 	X_^_X_^_X_^X	1.0
Ferisque Iuno tribuit, ut caelum mihi	fe&ri_sqve^ ju_no& tri^bu^i^t u&t c[ae]lu&m mi^hi& 	X_^_X^^^_X_^X	1.0
Faceret timendum - sparserit mundum licet	fa^ce^re&t ti^me_ndu&m spa_rse^ri&t mu&ndu&m li^ce&t 	^^_^_X_^_X_^X	1.0
Caelumque terris peius ac peius Styge	c[ae]lu_mqve^ te_rri&s p[ei]u^s a&c p[ei]u&s sty^ge& 	X_^_X_^_X_^X	1.0
Irata faciat, dabitur Alcidae locus.	i&ra_ta^ fa^ci^a&t da^bi^tu^r a_lci&d[ae] lo^cu&s 	X_^^^X^^^_X_^X	1.0
Si post feras, post bella, post Stygium canem	si& po&st fe^ra&s po&st be_lla^ po&st sty^gi^u&m ca^ne&m 	X_^_X_^_^^_^X	1.0
Hauddum astra merui, Siculus Hesperium latus	h[au]ddu&m a_stra^ me^ru^i& si^cu^lu^s he_spe^ri^u&m la^tu&s 	X_^^^X^^^_^^_^X	0.98
Tangat Pelorus, una iam tellus erit:	ta&nga&t pe^lo_ru&s u_na^ ja&m te&llu_s e^ri&t 	X_^_X_^_X_^X	1.0
Illinc fugabo maria; si iungi iubes,	i&lli&nc fu^ga_bo& ma^ri^a^ si_ ju&ngi_ ju^be&s 	X_^_X^^^_X_^X	1.0
Committat undas Isthmos, et iuncto salo	co&mmi_tta^t u_nda&s i_sthmo^s e&t ju&ncto_ sa^lo& 	X_^_X_^_X_^X	1.0
Noua ferantur Atticae puppes uia.	no&va_ fe^ra_ntu&r a_tti^c[ae] pu&ppe&s vi^a& 	X_^_X_^_X_^X	1.0
Mutetur orbis, uallibus currat nouis	mu&te_tu^r o_rbi&s va_lli^bu&s cu&rra&t no^vi&s 	X_^_X_^_X_^X	1.0
Hister nouasque Tanais accipiat uias.	hi&ste&r no^va_sqve& ta^na^i^s a_cci^pi^a&t vi^a&s 	X_^_X^^^_^^_^X	1.0
Da, da tuendos, Iuppiter, saltem deos:	da& da_ tu^e_ndo&s ju_ppi^te&r sa&lte&m de^o&s 	X_^_X_^_X_^X	1.0
Illa licebit fulmen a parte auferas,	i&lla_ li^ce_bi&t fu_lme^n a_ pa&rte& [au]fe^ra&s 	X_^_X_^_X_^X	0.94
Ego quam tuebor. siue glacialem polum,	e^go^ qva&m tu^e_bo&r si_ve^ gla^ci^a&le&m po^lu&m 	^^_^_X_^^^X_^X	1.0
Seu me tueri feruidam partem iubes,	s[eu] me_ tu^e_ri& fe_rvi^da_m pa&rte&m ju^be&s 	X_^_X_^_X_^X	1.0
Hac esse superos parte securos puta.	ha&c e_sse^ su^pe^ro&s pa_rte^ se_cu&ro&s pu^ta& 	X_^^^X_^_X_^X	1.0
Cirrhaea Paean templa et aetheriam domum	ci&rrh[ae]a^ p[ae]a&n te_mpla& e^t [ae]the^ri^a&m do^mu&m 	X_^_X_^_^^_^X	1.0
Serpente caeso meruit - o quotiens iacet	se&rpe_nte^ c[ae]so& me^ru^i^t o& qvo^ti^e&ns ja^ce&t 	X_^_X^^^_^^_^X	1.0
Python in hydra! Bacchus et Perseus deis	py&tho_n i^n hy_dra& ba_cchu^s e&t pe&rs[eu]s de^i&s 	X_^_X_^_X_^X	1.0
Iam se intulere - sed quota est mundi plaga	ja&m se& i_ntu^le_re& se&d qvo^ta& e&st mu&ndi& pla^ga& 	X_^_X_^_X_^X	0.72
Oriens subactus aut quota est Gorgon fera?	o^ri^e&ns su^ba_ctu&s [au]t qvo^ta& e&st go&rgo&n fe^ra& 	^^_^_X_^_X_^X	1.0
Quis astra natus laudibus meruit suis	qvi&s a_stra^ na_tu&s l[au]di^bu&s me^ru^i&t su^i&s 	X_^_X_^_^^_^X	1.0
Ex te et nouerca? quem tuli mundum peto.	e&x te& e&t no^ve_rca& qve&m tu^li_ mu&ndu&m pe^to& 	X_^_X_^_X_^X	1.0
Sed tu, comes laboris Herculei, Licha,	se&d tu_ co^me&s la&bo_ri^s he_rcu^le^i_ li^cha& 	X_^_X_^_^^_^X	1.0
Perfer triumphos, Euryti uictos lares	pe&rfe&r tri^u_mpho&s [eu]ry^ti_ vi&cto&s la^re&s 	X_^_X_^_X_^X	1.0
Stratumque regnum. uos pecus rapite ocius	stra&tu_mqve^ re_gnu&m vo&s pe^cu&s ra^pi^te& o_ci^u&s 	X_^_X_^_^^_^X	1.0
Qua templa tollens ora Cenaei Iouis	qva& te_mpla^ to_lle&ns o_ra^ ce_n[ae]i_ jo^vi&s 	X_^_X_^_X_^X	1.0
Aestu timendum spectat Euboicum mare.	[ae]stu_ ti^me_ndu&m spe_cta^t [eu]bo^i^cu&m ma^re& 	X_^_X_^_^^_^X	1.0
O quam cruentus feminas stimulat furor,	o& qva&m cru^e_ntu&s fe_mi^na&s sti^mu^la&t fu^ro&r 	X_^_X_^_^^_^X	1.0
Cum patuit una paelici et nuptae domus!	cu&m pa^tu^i^t u_na& p[ae]li^ci& e&t nu&pt[ae] do^mu&s 	X^^^_X_^_X_^X	1.0
Scylla et Charybdis Sicula contorquens freta	scy&lla& e&t cha^ry_bdi&s si^cu^la^ co_nto&rqve&ns fre^ta& 	X_^_X^^^_X_^X	0.94
Minus est timenda, nulla non melior fera est.	mi^nu^s e&st ti^me_nda& nu_lla^ no&n me^li^o&r fe^ra& e&st 	^^_^_X_^_^^_^X	1.0
Namque ut reluxit paelicis captae decus	na&mqve& u&t re^lu_xi&t p[ae]li^ci&s ca&pt[ae] de^cu&s 	X_^_X_^_X_^X	1.0
Et fulsit Iole qualis innubis dies	e&t fu_lsi^t i^o^le& qva_li^s i_nnu&bi&s di^e&s 	X_^^^X_^_X_^X	1.0
Purisue clarum noctibus sidus micat,	pu&ri_sve^ cla_ru&m no_cti^bu&s si&du&s mi^ca&t 	X_^_X_^_X_^X	1.0
Stetit furenti similis ac toruum intuens	ste&ti&t fu^re_nti& si^mi^li^s a&c to&rvu&m i_ntu^e&ns 	X_^_X^^^_X_^X	1.0
Herculea coniunx; feta ut Armenia iacens	he&rcu^le^a^ co_nju&nx fe_ta& u^t a_rme&ni^a^ ja^ce&ns	X^^^_X_^_X^^^X	m
Sub rupe tigris hoste conspecto exilit	su&b ru_pe^ ti_gri&s ho_ste^ co_nspe&cto& e_xi^li&t 	X_^_X_^_X_^X	1.0
Aut iussa thyrsum quatere conceptum ferens	[au]t ju_ssa^ thy_rsu&m qva^te^re^ co_nce&ptu&m fe^re&ns 	X_^_X^^^_X_^X	1.0
Maenas Lyaeum dubia quo gressus agat	m[ae]na&s ly^[ae]u&m du^bi^a^ qvo& gre&ssu_s a^ga&t 	X_^_X^^^_X_^X	0.92
Haesit parumper; tum per Herculeos lares	h[ae]si&t pa^ru_mpe&r tu&m pe^r he_rcu^le^o&s la^re&s 	X_^_X_^_^^_^X	1.0
Lymphata rapitur, tota uix satis est domus:	ly&mpha_ta^ ra^pi^tu&r to_ta^ vi&x sa^ti^s e&st do^mu&s 	X_^^^X_^_^^_^X	0.98
Incurrit, errat, sistit, in uultus dolor	i&ncu_rri^t e_rra&t si_sti^t i&n vu&ltu&s do^lo&r 	X_^_X_^_X_^X	1.0
Processit omnis, pectori paene intimo	pro&ce_ssi^t o_mni&s pe_cto^ri_ p[ae]ne& i_nti^mo& 	X_^_X_^_X_^X	1.0
Nihil est relictum; fletus insequitur minas.	ni^hi^l e&st re^li_ctu&m fle_tu^s i_nse^qvi^tu&r mi^na&s 	^^_^_X_^_^^_^X	0.33
Nec unus habitus durat aut uno furit	ne&c u_nu^s ha^bi^tu&s du_ra^t [au]t u&no_ fu^ri&t 	X_^^^X_^_X_^X	1.0
Contenta uultu: nunc inardescunt genae,	co&nte_nta^ vu_ltu& nu&nc i^na_rde&scu_nt ge^n[ae] 	X_^_X_^_X_^X	1.0
Pallor ruborem pellit et formas dolor	pa&llo&r ru^bo_re&m pe_lli^t e&t fo&rma&s do^lo&r 	X_^_X_^_X_^X	1.0
Errat per omnes; queritur implorat gemit.	e&rra&t pe^r o_mne&s qve^ri^tu^r i_mplo&ra&t ge^mi&t 	X_^_X^^^_X_^X	1.0
Sonuere postes ecce praecipiti gradu,	so^nu^e_re^ po_ste&s e_cce^ pr[ae]ci^pi^ti& gra^du& 	^^_^_X_^_^^_^X	1.0
Secreta mentis ore confuso exerit.	se&cre_ta^ me_nti&s o_re^ co_nfu&so& e_xe^ri&t 	X_^_X_^_X_^X	1.0
Quamcumque partem sedis aetheriae premis,	qva&mcu_mqve^ pa_rte&m se_di^s [ae]the^ri^[ae] pre^mi&s 	X_^_X_^_^^_^X	1.0
Coniunx Tonantis, mitte in Alciden feram	co&nju&nx to^na_nti&s mi_tte& i^n a_lci&de&n fe^ra&m 	X_^_X_^_X_^X	1.0
Quae mihi satis sit. si qua fecundum caput	qv[ae] mi^hi^ sa^ti&s si&t si& qva^ fe_cu&ndu&m ca^pu&t 	X^^^_X_^_X_^X	0.81
Palude tota uastior serpens mouet,	pa&lu_de^ to_ta& va_sti^o&r se&rpe&ns mo^ve&t 	X_^_X_^_X_^X	1.0
Ignara uinci, si quid excessit feras	i&gna_ra^ vi_nci& si& qvi^d e_xce&ssi&t fe^ra&s 	X_^_X_^_X_^X	1.0
Immane dirum horribile, quo uiso Hercules	i&mma_ne^ di_ru&m ho&rri^bi^le^ qvo_ vi&so& he_rcu^le&s 	X_^_X^^^_X_^X	1.0
Auertat oculos, hoc specu immenso exeat.	[au]e_rta^t o^cu^lo&s ho&c spe^cu& i_mme&nso& e_xe^a&t 	X_^^^X_^_X_^X	1.0
Vel si ferae negantur, hanc animam, precor,	ve&l si_ fe^r[ae] ne&ga_ntu^r ha&nc a^ni^ma&m pre^co&r 	X_^_X_^_^^_^X	1.0
Conuerte in aliquod - quodlibet possum malum	co&nve_rte& i^n a^li^qvo&d qvo_dli^be_t po&ssu&m ma^lu&m 	X_^^^X_^_X_^X	0.72
Hac mente fieri. commoda effigiem mihi	ha&c me_nte^ fi^e^ri& co_mmo^da& e_ffi^gi^e&m mi^hi& 	X_^^^X_^_^^_^X	1.0
Parem dolori: non capit pectus minas.	pa&re&m do^lo_ri& no&n ca^pi&t pe&ctu&s mi^na&s 	X_^_X_^_X_^X	1.0
Quid excutis telluris extremae sinus	qvi&d e_xcu^ti&s te&llu_ri^s e_xtre&m[ae] si^nu&s 	X_^_X_^_X_^X	1.0
Orbemque uersas? quid rogas Ditem mala?	o&rbe_mqve^ ve_rsa&s qvi&d ro^ga&s di&te&m ma^la& 	X_^_X_^_X_^X	0.94
Omnes in isto pectore inuenies feras	o&mne_s i^n i_sto& pe_cto^re& i_nve^ni^e&s fe^ra&s 	X_^_X_^_^^_^X	1.0
Quas timuit; odiis accipe hoc telum tuis:	qva&s ti^mu^i^t o^di^i&s a_cci^pe& ho&c te&lu&m tu^i&s 	X^^^^^X_^_X_^X	1.0
Ego sum, nouerca, perdere Alciden potens:	e^go^ su&m no^ve_rca& pe_rde^re& a_lci&de&n po^te&ns 	^^_^_X_^_X_^X	1.0
Perfer manus quocumque; quid cessas, dea?	pe&rfe&r ma^nu&s qvo&cu_mqve^ qvi&d ce&ssa&s de^a& 	X_^_X_^_X_^X	1.0
Vtere furente! quod iubes fieri nefas?	u&te^re^ fu^re_nte& qvo&d ju^be&s fi^e^ri_ ne^fa&s 	X^^^_X_^_^^_^X	1.0
Reperi, quid haeres? ipsa iam cesses licet,	re^pe^ri& qvi^d h[ae]re&s i_psa^ ja&m ce&sse&s li^ce&t	^^_^_X_^_X_^X	m
Haec ira satis est. Pectoris sani parum,	h[ae]c i_ra^ sa^ti^s e&st pe_cto^ri&s sa&ni_ pa^ru&m 	X_^^^X_^_X_^X	0.98
Alumna, questus comprime et flammas doma;	a&lu_mna^ qve_stu&s co_mpri^me& e&t fla&mma&s do^ma& 	X_^_X_^_X_^X	1.0
Frena dolorem. coniugem ostende Herculis.	fre&na_ do^lo_re&m co_nju^ge&m o_ste&nde& he_rcu^li&s 	X_^_X_^_X_^X	1.0
Iole meis captiua germanos dabit	i^o^le_ me^i&s ca&pti_va^ ge_rma&no&s da^bi&t 	^^_^_X_^_X_^X	1.0
Natis Iouisque fiet ex famula nurus?	na&ti&s jo^vi_sqve& fi_e^t e&x fa^mu^la_ nu^ru&s	X_^_X_^_^^_^X	m
Num flamma cursus pariter et torrens feret	nu&m fla_mma^ cu_rsu&s pa^ri^te^r e&t to&rre&ns fe^re&t 	X_^_X^^^_X_^X	1.0
Et ursa pontum sicca caeruleum bibet?	e&t u_rsa^ po_ntu&m si_cca^ c[ae]ru^le^u&m bi^be&t 	X_^_X_^_^^_^X	1.0
Non ibo inulta: gesseris caelum licet	no&n i_bo& i^nu_lta& ge_sse^ri&s c[ae]lu&m li^ce&t 	X_^_X_^_X_^X	1.0
Totusque pacem debeat mundus tibi,	to&tu_sqve^ pa_ce&m de_be^a&t mu&ndu&s ti^bi& 	X_^_X_^_X_^X	1.0
Est aliquid hydra peius: iratae dolor	e&st a^li^qvi^d hy_dra& p[ei]u^s i_ra&tae_ do^lo&r 	X^^^_X_^_X_^X	1.0
Nuptae. quis ignis tantus in caelum furit	nu&pt[ae] qvi^s i_gni&s ta_ntu^s i&n c[ae]lu&m fu^ri&t 	X_^_X_^_X_^X	0.76
Ardentis Aetnae? quidquid est uictum tibi	a&rde_nti^s [ae]tn[ae] qvi_dqvi^d e&st vi&ctu&m ti^bi& 	X_^_X_^_X_^X	0.75
Hic uincet animus - capta praeripiet toros?	hi&c vi_nce^t a^ni^mu&s ca_pta^ pr[ae]ri^pi^e&t to^ro&s 	X_^^^X_^_^^_^X	1.0
Adhuc timebam monstra, iam nullum est malum:	a&dhu&c ti^me_ba&m mo_nstra^ ja&m nu&llu&m e&st ma^lu&m 	X_^_X_^_X_^X	0.72
Cessere pestes, in locum uenit ferae	ce&sse_re^ pe_ste&s i&n lo^cu&m ve&ni&t fe^r[ae] 	X_^_X_^_X_^X	1.0
Inuisa paelex. summe pro rector deum	i&nvi_sa^ p[ae]le&x su_mme^ pro_ re&cto&r de^u&m 	X_^_X_^_X_^X	1.0
Et clare Titan, Herculis tantum fui	e&t cla_re^ ti_ta&n he_rcu^li&s ta&ntu&m fu^i& 	X_^_X_^_X_^X	0.5
Coniunx timentis; uota quae superis tuli	co&nju&nx ti^me_nti&s vo_ta^ qv[ae] su^pe^ri&s tu^li& 	X_^_X_^_^^_^X	1.0
Cessere captae, paelici felix fui,	ce&sse_re^ ca_pt[ae] p[ae]li^ci_ fe&li&x fu^i& 	X_^_X_^_X_^X	1.0
Illi meas audistis, o superi, preces,	i&lli_ me^a_s [au]di_sti^s o_ su^pe^ri& pre^ce&s 	X_^_X_^_^^_^X	1.0
Incolumis illi remeat - o nulla dolor	i&nco^lu^mi^s i_lli& re^me^a^t o_ nu&lla_ do^lo&r 	X^^^_X^^^_X_^X	1.0
Contente poena, quaere supplicia horrida,	co&nte_nte^ p[oe]na& qv[ae]re^ su_ppli^ci^a& ho_rri^da& 	X_^_X_^_^^_^X	1.0
Incogitata, infanda, Iunonem doce	i&nco_gi^ta_ta& i&nfa_nda^ ju_no&ne&m do^ce& 	X_^_X_^_X_^X	1.0
Quid odia ualeant: nescit irasci satis.	qvi&d o^di^a^ va^le^a&nt ne_sci^t i_ra&sci_ sa^ti&s 	X^^^^^X_^_X_^X	1.0
Pro me gerebas bella, propter me uagas	pro& me_ ge^re_ba&s be_lla^ pro_pte&r me_ va^ga&s 	X_^_X_^_X_^X	1.0
Achelous undas sanguine infecit suo,	a^che^lo_u^s u_nda&s sa_ngvi^ne& i_nfe&ci&t su^o& 	^^_^_X_^_X_^X	1.0
Cum lenta serpens fieret, in taurum trucem	cu&m le_nta^ se_rpe&ns fi^e^re^t i&n t[au]ru&m tru^ce&m 	X_^_X^^^_X_^X	1.0
Nunc flecteret serpente deposita minas,	nu&nc fle_cte^re&t se&rpe_nte^ de_po^si^ta_ mi^na&s	X_^_X_^_^^_^X	m
Et mille in hoste uinceres uno feras.	e&t mi_lle& i^n ho_ste& vi_nce^re_s u&no_ fe^ra&s 	X_^_X_^_X_^X	1.0
Iam displicemus, capta praelata est mihi -	ja&m di_spli^ce_mu&s ca_pta^ pr[ae]la&ta& e&st mi^hi& 	X_^_X_^_X_^X	1.0
Non praeferetur: qui dies thalami ultimus	no&n pr[ae]fe^re_tu&r qvi_ di^e&s tha^la^mi& u_lti^mu&s 	X_^_X_^_^^_^X	1.0
Nostri est futurus, hic erit uitae tuae.	no&stri& e&st fu^tu_ru&s hi_c e^ri&t vi&t[ae] tu^[ae] 	X_^_X_^_X_^X	0.99
Quid hoc? recedit animus et ponit minas;	qvi&d ho&c re^ce_di&t a^ni^mu^s e&t po&ni&t mi^na&s 	X_^_X^^^_X_^X	1.0
Iam cessat ira - quid miser langues dolor?	ja&m ce_ssa^t i_ra& qvi&d mi^se&r la&ngve&s do^lo&r 	X_^_X_^_X_^X	1.0
Perdis furorem, coniugis sanctae fidem	pe&rdi&s fu^ro_re&m co_nju^gi&s sa&nct[ae] fi^de&m 	X_^_X_^_X_^X	1.0
Mihi reddis iterum. quid uetas flammas ali?	mi^hi^ re_ddi^s i^te^ru&m qvi&d ve^ta&s fla&mma_s a^li& 	^^_^^^X_^_X_^X	0.81
Quid frangis ignes? hunc mihi serua impetum,	qvi&d fra_ngi^s i_gne&s hu&nc mi^hi_ se&rva& i_mpe^tu&m 	X_^_X_^_X_^X	0.19
Pares eamus - non erit uotis opus:	pa&re_s e^a_mu&s no_n e^ri&t vo&ti_s o^pu&s 	X_^_X_^_X_^X	1.0
Aderit nouerca quae manus nostras regat	a^de^ri&t no^ve_rca& qv[ae] ma^nu&s no&stra&s re^ga&t 	^^_^_X_^_X_^X	1.0
Nec inuocata. Quod paras demens scelus?	ne&c i_nvo^ca_ta& qvo&d pa^ra&s de&me&ns sce^lu&s 	X_^_X_^_X_^X	1.0
Perimes maritum, cuius extremus dies	pe^ri^me&s ma^ri_tu&m cu_ju^s e_xtre&mu&s di^e&s 	^^_^_X_^_X_^X	1.0
Primusque laudes nouit et caelo tenus	pri&mu_sqve^ l[au]de&s no_vi^t e&t c[ae]lo_ te^nu&s 	X_^_X_^_X_^X	1.0
Erecta terras fama suppositas habet?	e&re_cta^ te_rra&s fa_ma^ su_ppo^si^ta&s ha^be&t	X_^_X_^_^^_^X	m
Iam tota in istos terra consurget lares	ja&m to_ta& i^n i_sto&s te_rra^ co_nsu&rge&t la^re&s 	X_^_X_^_X_^X	1.0
Domusque soceri prima et Aetolum genus	do&mu_sqve^ so^ce^ri& pri_ma& e^t [ae]to&lu&m ge^nu&s 	X_^^^X_^_X_^X	1.0
Sternetur omne, saxa iam dudum ac faces	ste&rne_tu^r o_mne& sa_xa^ ja&m du&du&m a&c fa^ce&s 	X_^_X_^_X_^X	0.98
In te ferentur, uindicem tellus suum	i&n te_ fe^re_ntu&r vi_ndi^ce&m te&llu&s su^u&m 	X_^_X_^_X_^X	1.0
Defendet omnis: una quot poenas dabis!	de&fe_nde^t o_mni&s u_na^ qvo&t p[oe]na&s da^bi&s 	X_^_X_^_X_^X	1.0
Effugere terras crede et humanum genus	e&ffu^ge^re^ te_rra&s cre_de& e^t hu_ma&nu&m ge^nu&s 	X^^^_X_^_X_^X	0.75
Te posse - fulmen genitor Alcidae gerit:	te& po_sse^ fu_lme&n ge^ni^to^r a_lci&d[ae] ge^ri&t 	X_^_X^^^_X_^X	0.01
Iam iam minaces ire per caelum faces	ja&m ja&m mi^na_ce&s i_re^ pe&r c[ae]lu&m fa^ce&s 	X_^_X_^_X_^X	0.98
Specta et tonantem fulmine excusso diem.	spe&cta& e&t to^na_nte&m fu_lmi^ne& e_xcu&sso_ di^e&m 	X_^_X_^_X_^X	1.0
Mortem quoque ipsam, quam putes tutam, time:	mo&rte&m qvo^qve& i_psa&m qva&m pu^te&s tu&ta&m ti^me& 	X_^_X_^_X_^X	0.93
Dominatur illic patruus Alcidae tui.	do^mi^na_tu^r i_lli&c pa^tru^u^s a_lci&d[ae] tu^i& 	^^_^_X^^^_X_^X	1.0
Quocumque perges, misera, cognatos deos	qvo&cu_mqve^ pe_rge&s mi^se^ra^ co_gna&to&s de^o&s 	X_^_X^^^_X_^X	1.0
Illi uidebis. Maximum fieri scelus	i&lli_ vi^de_bi&s ma_xi^mu&m fi^e^ri& sce^lu&s 	X_^_X_^_^^_^X	1.0
Et ipsa fateor, sed dolor fieri iubet.	e&t i_psa^ fa^te^o&r se&d do^lo&r fi^e^ri_ ju^be&t 	X_^^^X_^_^^_^X	1.0
Moriere. Moriar Herculis nempe incluti	mo^ri^e_re^ mo^ri^a&r he_rcu^li&s ne&mpe& i_nclu^ti& 	^^_^^^X_^_X_^X	1.0
Coniunx nec ullus nocte discussa dies	co&nju&nx ne^c u_llu&s no_cte^ di_scu&ssa_ di^e&s 	X_^_X_^_X_^X	1.0
Viduam notabit nec meos paelex toros	vi^du^a_m no^ta_bi&t ne&c me^o&s p[ae]le&x to^ro&s 	^^_^_X_^_X_^X	1.0
Captiua capiet. ante ab occasu dies	ca&pti_va^ ca^pi^e&t a_nte& a^b o_cca&su_ di^e&s 	X_^^^X_^_X_^X	1.0
Nascetur, Indos ante glacialis polus	na&sce_tu^r i_ndo&s a_nte^ gla^ci^a&li&s po^lu&s 	X_^_X_^^^X_^X	1.0
Scythasue tepida Phoebus inficiet rota,	scy&tha_sve^ te^pi^da& ph[oe]bu^s i_nfi^ci^e&t ro^ta&	X_^^^X_^_^^_^X	m
Quam me relictam Thessalae inspiciant nurus.	qva&m me_ re^li_cta&m the_ssa^l[ae] i_nspi^ci^a&nt nu^ru&s 	X_^_X_^_^^_^X	1.0
Meo iugales sanguine extinguam faces.	me&o_ ju^ga_le&s sa_ngvi^ne& e_xti&ngva_m fa^ce&s 	X_^_X_^_X_^X	0.98
Aut pereat aut me perimat; elisis feris	[au]t pe^re^a^t [au]t me& pe^ri^ma^t e_li&si&s fe^ri&s 	X^^^_X^^^_X_^X	1.0
Et coniugem addat, inter Herculeos licet	e&t co_nju^ge&m a_dda&t i_nte^r he_rcu^le^o&s li^ce&t 	X_^_X_^_^^_^X	1.0
Me quoque labores numeret: Alcidae toros	me& qvo^qve^ la^bo_re&s nu^me^re^t a_lci&d[ae] to^ro&s 	X^^^_X^^^_X_^X	0.93
Moritura certe corpore amplectar meo.	mo^ri^tu_ra^ ce_rte& co_rpo^re& a_mple&cta&r me^o& 	^^_^_X_^_X_^X	1.0
Ire, ire ad umbras Herculis nuptam libet,	i&re& i_re& a^d u_mbra&s he_rcu^li&s nu&pta&m li^be&t 	X_^_X_^_X_^X	1.0
Sed non inultam: si quid ex nostro Hercule	se&d no_n i^nu_lta&m si& qvi^d e&x no&stro& he_rcu^le& 	X_^_X_^_X_^X	1.0
Concepit Iole, manibus euellam meis	co&nce_pi^t i^o^le& ma^ni^bu^s [eu]e&lla&m me^i&s 	X_^^^X^^^_X_^X	0.66
Ante et per ipsas paelicem inuadam faces.	a&nte& e&t pe^r i_psa&s p[ae]li^ce&m i_nva&da&m fa^ce&s 	X_^_X_^_X_^X	0.98
Me nuptiali uictimam feriat die	me& nu_pti^a_li& vi_cti^ma&m fe^ri^a&t di^e& 	X_^_X_^_^^_^X	1.0
Infestus, Iolen dum supra exanimem ruam:	i&nfe_stu^s i^o^le&n du&m su^pra& e_xa^ni^me&m ru^a&m 	X_^^^X_^_^^_^X	0.12
Felix iacet quicumque quos odit premit.	fe&li&x ja^ce&t qvi&cu_mqve^ qvo_s o&di&t pre^mi&t 	X_^_X_^_X_^X	1.0
Quid ipsa flammas pascis et uastum foues	qvi&d i_psa^ fla_mma&s pa_sci^s e&t va&stu&m fo^ve&s 	X_^_X_^_X_^X	1.0
Vltro dolorem? misera, quid cassum times?	u&ltro_ do^lo_re&m mi^se^ra^ qvi&d ca&ssu&m ti^me&s 	X_^_X^^^_X_^X	1.0
Dilexit Iolen: nempe cum staret parens	di&le_xi^t i^o^le&n ne_mpe^ cu&m sta&re&t pa^re&ns 	X_^^^X_^_X_^X	0.97
Regisque natam peteret - in famulae locum	re&gi_sque^ na_ta&m p^ete^re^t - i&n fa^mu^l[ae] lo^cu&m 	X_^_X^^^_^^_^X	m
Regina cecidit: perdidit uires amor	re&gi_na^ ce^ci^di&t pe_rdi^di&t vi&re_s a^mo&r 	X_^^^X_^_X_^X	0.97
Multumque ab illa traxit infelix status.	mu&ltu_mqve& a^b i_lla& tra_xi^t i_nfe&li&x sta^tu&s 	X_^_X_^_X_^X	1.0
Illicita amantur, excidit quidquid licet.	i&lli^ci^ta& a^ma_ntu&r e_xci^di&t qvi&dqvi&d li^ce&t 	X^^^_X_^_X_^X	1.0
Fortuna amorem peior inflammat magis:	fo&rtu_na& a^mo_re&m p[ei]o^r i_nfla&mma&t ma^gi&s 	X_^_X_^_X_^X	1.0
Amat uel ipsum quod caret patrio lare,	a&ma&t ve^l i_psu&m qvo&d ca^re&t pa^tri^o_ la^re& 	X_^_X_^_^^_^X	1.0
Quod nudus auro crinis et gemma iacet,	qvo&d nu_du^s [au]ro& cri_ni^s e&t ge&mma_ ja^ce&t 	X_^_X_^_X_^X	0.56
Ipsas misericors forsan aerumnas amat;	i&psa&s mi^se^ri^co&rs fo_rsa^n [ae]ru&mna_s a^ma&t 	X_^^^X_^_X_^X	1.0
Hoc usitatum est Herculi: captas amat.	ho&c u_si^ta_tu&m e&st he_rcu^li_ ca&pta_s a^ma&t 	X_^_X_^_X_^X	1.0
Dilecta Priami nempe Dardanii soror	di&le_cta^ pri^a^mi& ne_mpe^ da_rda^ni^i_ so^ro&r 	X_^^^X_^_^^_^X	1.0
Concessa famula est; adice quot nuptas prius,	co_nce_ssa^ fa^mu^la& e&st; a^di^ce^ quo&t nu_pta&s pri^u&s,	X_^^^X^^^_X_^X	m
Quot uirgines dilexit: errauit uagus.	qvo&t vi_rgi^ne&s di&le_xi^t e_rr[au]i&t va^gu&s 	X_^_X_^_X_^X	1.0
Arcadia nempe uirgo, Palladios choros	a&rca^di^a^ ne_mpe& vi_rgo^ pa_lla^di^o&s cho^ro&s 	X^^^_X_^_^^_^X	0.47
Dum nectit, Auge, uim stupri passa excidit,	du&m ne_cti^t, [au]ge^, ui&m stu^pri_ pa_ssa& e_xci^di&t, 	X_^_X_^_X_^X	m
Nullamque amoris Hercules retinet notam.	nu&lla_mqve& a^mo_ri&s he_rcu^le&s re^ti^ne&t no^ta&m 	X_^_X_^_^^_^X	0.57
Referam quid alias? nempe Thespiades uacant	re^fe^ra&m qvi^d a^li^a&s ne_mpe^ the_spi^a^de&s va^ca&nt	^^_^^^X_^_^^_^X	m
Breuique in illis arsit Alcides face.	bre&vi_qve& i^n i_lli&s a_rsi^t a_lci&de&s fa^ce& 	X_^_X_^_X_^X	1.0
Hospes Timoli Lydiam fouit nurum	ho&spe&s ti^mo_li& ly_di^a_m fo&vi&t nu^ru&m 	X_^_X_^_X_^X	1.0
Et amore captus ad leues sedit colos,	e^t a^mo_re^ ca_ptu&s a&d le^ve&s se&di&t co^lo&s 	^^_^_X_^_X_^X	0.97
Tenerum feroci stamen intorquens manu.	te^ne^ru&m fe^ro_ci& sta_me^n i_nto&rqve&ns ma^nu& 	^^_^_X_^_X_^X	1.0
Nempe illa ceruix spolia deposuit ferae	ne&mpe& i_lla^ ce_rvi&x spo^li^a^ de_po^su^i&t fe^r[ae] 	X_^_X^^^_^^_^X	1.0
Crinemque mitra pressit et famulus stetit,	cri&ne_mqve^ mi_tra& pre_ssi^t e&t fa^mu^lu&s ste^ti&t 	X_^_X_^_^^_^X	1.0
Hirtam Sabaea marcidus myrrha comam:	hi&rta&m sa^b[ae]a& ma_rci^du&s my&rrha_ co^ma&m 	X_^_X_^_X_^X	1.0
Vbique caluit, sed leui caluit face.	u&bi_qve^ ca^lu^i&t se&d le^vi_ ca^lu^i&t fa^ce& 	X_^^^X_^_^^_^X	0.96
Haerere amantes post uagos ignes solent.	h[ae]re_re& a^ma_nte&s po&st va^go_s i&gne&s so^le&nt 	X_^_X_^_X_^X	1.0
Famulamne et hostis praeferet gnatam tibi?	fa^mu^la_mne& e^t ho_sti&s pr[ae]fe^re&t gna&ta_m ti^bi& 	^^_^_X_^_X_^X	1.0
Vt laeta siluas forma uernantes habet,	u&t l[ae]ta^ si_lva&s fo_rma^ ve_rna&nte_s ha^be&t 	X_^_X_^_X_^X	1.0
Quas nemore nudo primus inuestit tepor,	qva&s ne^mo^re^ nu_do& pri_mu^s i_nve&sti_t te^po&r 	X^^^_X_^_X_^X	0.99
At cum solutos expulit Boreas Notos	a&t cu&m so^lu_to&s e_xpu^li&t bo^re^a&s no^to&s 	X_^_X_^_^^_^X	0.79
Et saeua totas bruma decussit comas,	e&t s[ae]va^ to_ta&s bru_ma^ de_cu&ssi_t co^ma&s 	X_^_X_^_X_^X	1.0
Deforme solis aspicis truncis nemus:	de&fo_rme^ so_li&s a_spi^ci&s tru&nci&s ne^mu&s 	X_^_X_^_X_^X	1.0
Sic nostra longum forma percurrens iter	si&c no_stra^ lo_ngu&m fo_rma^ pe_rcu&rre&ns i^te&r 	X_^_X_^_X_^X	1.0
Deperdit aliquid semper et fulget minus,	de&pe_rdi^t a^li^qvi&d se_mpe^r e&t fu&lge&t mi^nu&s 	X_^^^X_^_X_^X	1.0
Nec illa uenus est: quidquid in nobis fuit	ne&c i_lla^ ve^nu^s e&st qvi_dqvi^d i&n no&bi&s fu^i&t 	X_^^^X_^_X_^X	0.98
Olim petitum cecidit et periit labans,	o&li&m pe^ti_tu&m ce^ci^di^t e&t pe^ri^i&t la^ba&ns 	X_^_X^^^_^^_^X	0.97
Aetas citato senior eripuit gradu	[ae]ta&s ci^ta_to& se^ni^o^r e_ri^pu^i&t gra^du& 	X_^_X^^^_^^_^X	1.0
Materque multum rapuit ex illo mihi.	ma&te_rqve^ mu_ltu&m ra^pu^i^t e&x i&llo_ mi^hi& 	X_^_X^^^_X_^X	1.0
Vides ut altum famula non perdat decus?	vi&de_s u^t a_ltu&m fa^mu^la^ no&n pe&rda&t de^cu&s 	X_^_X^^^_X_^X	1.0
Cessere cultus penitus et paedor sedet;	ce&sse_re^ cu_ltu&s pe^ni^tu^s e&t p[ae]do&r se^de&t 	X_^_X^^^_X_^X	1.0
Tamen per ipsas fulget aerumnas decor	ta&me&n pe^r i_psa&s fu_lge^t [ae]ru&mna_s de^co&r 	X_^_X_^_X_^X	1.0
Nihilque ab illa casus et fatum graue	ni&hi_lqve& a^b i_lla& ca_su^s e&t fa&tu&m gra^ve& 	X_^_X_^_X_^X	0.39
Nisi regna traxit. hic meum pectus timor,	ni^si^ re_gna^ tra_xi&t hi&c me^u&m pe&ctu&s ti^mo&r 	^^_^_X_^_X_^X	0.97
Altrix, lacessit, hic rapit somnos pauor.	a&ltri&x la^ce_ssi&t hi&c ra^pi&t so&mno&s pa^vo&r 	X_^_X_^_X_^X	1.0
Praeclara totis gentibus coniunx eram	pr[ae]cla_ra^ to_ti&s ge_nti^bu&s co&nju&nx e^ra&m 	X_^_X_^_X_^X	1.0
Thalamosque nostros inuido uoto nurus	tha^la^mo_sqve^ no_stro&s i_nvi^do_ vo&to_ nu^ru&s 	^^_^_X_^_X_^X	1.0
Optabat omnis, quae nimis quicquam deos	o&pta_ba^t o_mni&s qv[ae] ni^mi&s qvi&cqva&m de^o&s 	X_^_X_^_X_^X	1.0
Orabat ullos: nuribus Argolicis fui	o&ra_ba^t u_llo&s nu^ri^bu^s a_rgo^li^ci&s fu^i& 	X_^_X^^^_^^_^X	1.0
Mensura uoti. quem Ioui socerum parem,	me&nsu_ra^ vo_ti& qve&m jo^vi_ so^ce^ru&m pa^re&m 	X_^_X_^_^^_^X	1.0
Altrix, habebo? quis sub hoc mundo mihi	a&ltri&x ha^be_bo& qvi&s su^b ho&c mu&ndo_ mi^hi& 	X_^_X_^_X_^X	1.0
Dabitur maritus? ipse qui Alcidae imperat,	da^bi^tu&r ma^ri_tu&s i_pse^ qvi& a_lci&d[ae] i_mpe^ra&t 	^^_^_X_^_X_^X	1.0
Facibus suis me iungat Eurystheus licet,	fa^ci^bu&s su^i&s me& ju_nga^t [eu]ry&sth[eu]s li^ce&t 	^^_^_X_^_X_^X	1.0
Minus est. toris caruisse regnantis leue est:	mi^nu^s e&st to^ri&s ca^ru^i_sse^ re_gna&nti&s le^ve& e&st 	^^_^_^^_^_X_^X	0.92
Alte illa cecidit quae uiro caret Hercule.	a&lte& i_lla^ ce^ci^di&t qv[ae] vi^ro_ ca^re^t he_rcu^le& 	X_^^^X_^_^^_^X	0.97
Conciliat animos coniugum partus fere.	co&nci^li^a^t a^ni^mo&s co_nju^gu&m pa&rtu&s fe^re& 	X^^^^^X_^_X_^X	1.0
Hic ipse forsan diuidet partus toros.	hi&c i_pse^ fo_rsa&n di_vi^de&t pa&rtu&s to^ro&s 	X_^_X_^_X_^X	1.0
Famula illa trahitur interim donum tibi.	fa^mu^la& i_lla^ tra^hi^tu&r i_nte^ri_m do&nu&m ti^bi& 	^^_^^^X_^_X_^X	1.0
Hic quem per urbes ire praeclarum uides	hi&c qve&m pe^r u_rbe&s i_re^ pr[ae]cla&ru&m vi^de&s 	X_^_X_^_X_^X	1.0
Et uiua tergo spolia gestantem ferae,	e&t vi_va^ te_rgo& spo^li^a^ ge_sta&nte&m fe^r[ae] 	X_^_X^^^_X_^X	1.0
Qui regna miseris donat et celsis rapit	qvi& re_gna^ mi^se^ri&s do_na^t e&t ce&lsi&s ra^pi&t 	X_^^^X_^_X_^X	0.98
Vasta grauatus horridam claua manum,	va&sta_ gra^va_tu&s ho_rri^da&m cl[au]a_ ma^nu&m 	X_^_X_^_X_^X	1.0
Cuius triumphos ultimi Seres canunt	cu&ju&s tri^u_mpho&s u_lti^mi_ se&re&s ca^nu&nt 	X_^_X_^_X_^X	1.0
Et quisquis alius orbe consaepto iacet,	e&t qvi_sqvi^s a^li^u&s o_rbe^ co_ns[ae]pto_ ja^ce&t 	X_^^^X_^_X_^X	1.0
Leuis est nec illum gloriae stimulat decor.	le^vi^s e&st ne^c i_llu&m glo_ri^[ae] sti^mu^la&t de^co&r 	^^_^_X_^_^^_^X	0.9
Errat per orbem, non ut aequetur Ioui	e&rra&t pe^r o_rbe&m no_n u^t [ae]qve&tu&r jo^vi& 	X_^_X_^_X_^X	1.0
Nec ut per urbes magnus Argolicas eat:	ne&c u&t pe^r u_rbe&s ma_gnu^s a_rgo^li^ca_s e^a&t 	X_^_X_^_^^_^X	1.0
Quod amet requirit, uirginum thalamos petit.	qvo^d a^me&t re^qvi_ri&t vi_rgi^nu&m tha^la^mo&s pe^ti&t	^^_^_X_^_^^_^X	m
Si qua est negata, rapitur; in populos furit,	si& qva& e&st ne^ga_ta& ra^pi^tu^r i&n po^pu^lo&s fu^ri&t 	X_^_X^^^_^^_^X	1.0
Nuptas ruinis quaerit et uitium impotens	nu&pta&s ru^i_ni&s qv[ae]ri^t e&t vi^ti^u&m i_mpo^te&ns 	X_^_X_^_^^_^X	1.0
Virtus uocatur. cecidit Oechalia inclita	vi&rtu&s vo^ca_tu&r ce^ci^di^t [oe]cha^li^a& i_ncli^ta& 	X_^_X^^^_^^_^X	0.97
Vnusque Titan uidit atque unus dies	u&nu_sqve^ ti_ta&n vi_di^t a_tqve& u&nu&s di^e&s 	X_^_X_^_X_^X	1.0
Stantem et cadentem; causa bellandi est amor.	sta&nte&m e&t ca^de_nte&m c[au]sa^ be_lla&ndi& e&st a^mo&r 	X_^_X_^_X_^X	1.0
Totiens timebit Herculi natam parens	to^ti^e&ns ti^me_bi&t he_rcu^li_ na&ta&m pa^re&ns 	^^_^_X_^_X_^X	0.97
Quotiens negabit, hostis est quotiens socer	qvo^ti^e&ns ne^ga_bi&t ho_sti^s e&st qvo^ti^e&ns so^ce&r 	^^_^_X_^_^^_^X	0.93
Fieri recusat: si gener non est, ferit.	fi^e^ri_ re^cu_sa&t si_ ge^ne&r no&n e&st fe^ri&t 	^^_^_X_^_X_^X	1.0
Post haec quid istas innocens seruo manus,	po&st h[ae]c qui^d i_sta&s i_nno^ce&ns se_ruo_ ma^nu_s, 	X_^_X_^_X_^X	m
Donec furentem simulet ac saeua manu	do&ne&c fu^re_nte&m si^mu^le^t a&c s[ae]va_ ma^nu& 	X_^_X^^^_X_^X	1.0
Intendat arcus meque natumque opprimat?	i&nte_nda^t a_rcu&s me_qve^ na_tu&mqve& o_ppri^ma&t 	X_^_X_^_X_^X	1.0
Sic coniuges expellit Alcides suas,	si&c co_nju^ge_s e&xpe_lli^t a_lci&de&s su^a&s 	X_^_X_^_X_^X	1.0
Haec sunt repudia; nec potest fieri nocens:	h[ae]c su&nt re^pu^di^a& ne&c po^te&st fi^e^ri_ no^ce&ns	X_^^^X_^_^^_^X	m
Terris uideri sceleribus causam suis	te&rri&s vi^de_ri& sce^le^ri^bu_s c[au]sa&m su^i&s 	X_^_X^^^_X_^X	1.0
Fecit nouercam. quid stupes segnis, furor?	fe&ci&t no^ve_rca&m qvi&d stu^pe&s se&gni&s fu^ro&r 	X_^_X_^_X_^X	1.0
Scelus occupandum est: perage, dum feruet manus.	sce^lu^s o_ccu^pa_ndu&m e&st pe^ra^ge^ du&m fe&rve&t ma^nu&s 	^^_^_X^^^_X_^X	1.0
Perimes maritum? Paelicis certe meae.	pe^ri^me&s ma^ri_tu&m p[ae]li^ci&s ce&rte_ me^[ae] 	^^_^_X_^_X_^X	1.0
At Ioue creatum. Nempe et Alcmena satum.	a&t jo^ve^ cre^a_tu&m ne_mpe& e^t a_lcme&na_ sa^tu&m 	X^^^_X_^_X_^X	1.0
Ferrone? Ferro. Si nequis? Perimam dolo.	fe&rro_ne^? fe_rro&. si_ ne^qui&s? pe^ri^ma&m do^lo&. 	X_^_X_^_^^_^X	m
Quis iste furor est? Quem meus coniunx docet.	qvi&s i_ste^ fu^ro^r e&st qve&m me^u&s co&nju&nx do^ce&t 	X_^^^X_^_X_^X	1.0
Quem nec nouerca potuit, hunc perimes uirum?	qve&m ne&c no^ve_rca& po^tu^i^t hu&nc pe^ri^me&s vi^ru&m	X_^_X^^^_^^_^X	m
Caelestis ira quos premit, miseros facit:	c[ae]le_sti^s i_ra& qvo&s pre^mi&t mi^se^ro&s fa^ci&t 	X_^_X_^_^^_^X	1.0
Humana nullos. Parce, miseranda, et time.	hu&ma_na^ nu_llo&s pa_rce^ mi^se^ra&nda& e&t ti^me& 	X_^_X_^^^X_^X	0.97
Contempsit omnes ille qui mortem prius;	co&nte_mpsi^t o_mne&s i_lle^ qvi_ mo&rte&m pri^u&s 	X_^_X_^_X_^X	1.0
Libet ire in enses. Maior admisso tuus,	li^be^t i_re& i^n e_nse&s ma_jo^r a_dmi&sso_ tu^u&s 	^^_^_X_^_X_^X	1.0
Alumna, dolor est; culpa par odium exigat.	a&lu_mna^ do^lo^r e&st cu_lpa^ pa_r o^di^u&m e_xi^ga&t 	X_^^^X_^_^^_^X	0.98
Cur saeua modicis statuis? ut laesa es, dole.	cu&r s[ae]va^ mo^di^ci&s sta^tu^i^s u&t l[ae]sa& e&s do^le& 	X_^^^X^^^_X_^X	1.0
Leue esse credis paelicem nuptae malum?	le&ve& e_sse^ cre_di&s p[ae]li^ce_m nu&pt[ae] ma^lu&m 	X_^_X_^_X_^X	0.72
Quidquid dolorem pascit, hoc nimium puta.	qvi&dqvi&d do^lo_re&m pa_sci^t ho&c ni^mi^u&m pu^ta& 	X_^_X_^_^^_^X	1.0
Amorne clari fugit Alcidae tibi?	a&mo_rne^ cla_ri& fu_gi^t a_lci&d[ae] ti^bi& 	X_^_X_^_X_^X	0.24
Non fugit, altrix, remanet et penitus sedet	no&n fu_gi^t a_ltri&x re^ma^ne^t e&t pe^ni^tu&s se^de&t 	X_^_X^^^_^^_^X	0.24
Fixus medullis, crede; sed magnus dolor	fi&xu&s me^du_lli&s cre_de^ se&d ma&gnu&s do^lo&r 	X_^_X_^_X_^X	1.0
Iratus amor est. Artibus magicis fere	i&ra_tu^s a^mo^r e&st a_rti^bu&s ma^gi^ci&s fe^re& 	X_^^^X_^_^^_^X	0.88
Coniugia nuptae precibus admixtis ligant.	co&nju^gi^a^ nu_pt[ae] pre^ci^bu^s a_dmi&xti&s li^ga&nt 	X^^^_X^^^_X_^X	1.0
Vernare iussi frigore in medio nemus	ve&rna_re^ ju_ssi& fri_go^re& i&n me^di^o_ ne^mu&s 	X_^_X_^_^^_^X	1.0
Missumque fulmen stare; concussi fretum	mi&ssu_mqve^ fu_lme&n sta_re^ co_ncu&ssi& fre^tu&m 	X_^_X_^_X_^X	0.96
Cessante uento, turbidum explicui mare	ce&ssa_nte^ ve_nto& tu_rbi^du&m e_xpli&cui_ ma^re& 	X_^_X_^_X_^X	1.0
Et sicca tellus fontibus patuit nouis.	e&t si_cca^ te_llu&s fo_nti^bu&s pa^tu^i&t no^vi&s 	X_^_X_^_^^_^X	1.0
Habuere motum saxa, discussi fores	ha^bu^e_re^ mo_tu&m sa_xa^ di_scu&ssi_ fo^re&s 	^^_^_X_^_X_^X	1.0
Vmbrasque Ditis, et mea iussi prece	u&mbra_sqve^ di_ti&s e&t me^a_ ju&ssi& pre^ce& 	X_^_X_^_X_^X	1.0
Manes locuntur, siluit infernus canis;	ma&ne&s lo^cu_ntu&r si^lu^i^t i_nfe&rnu&s ca^ni&s 	X_^_X^^^_X_^X	0.4
Nox media solem uidit et noctem dies:	no&x me^di^a^ so_le&m vi_di^t e&t no&cte&m di^e&s 	X^^^_X_^_X_^X	1.0
Mare terra caelum et Tartarus seruit mihi	ma^re^ te_rra^ c[ae]lu&m e&t ta_rta^ru&s se&rvi&t mi^hi& 	^^_^_X_^_X_^X	1.0
Nihilque leges ad meos cantus tenet:	ni&hi_lqve^ le_ge&s a&d me^o&s ca&ntu&s te^ne&t 	X_^_X_^_X_^X	0.96
Flectemus illum, carmina inuenient iter.	fle&cte_mu^s i_llu&m ca_rmi^na& i_nve^ni^e&nt i^te&r 	X_^_X_^_^^_^X	1.0
Quas Pontus herbas generat aut quas Thessala	qva&s po_ntu^s he_rba&s ge^ne^ra^t [au]t qva&s the_ssa^la& 	X_^_X^^^_X_^X	1.0
Sub rupe Pindus aluit inueniam malum	su&b ru_pe^ pi_ndu&s a^lu^i^t i_nve^ni^a&m ma^lu&m 	X_^_X^^^_^^_^X	m
Cui cedat ille? carmine in terras mago	cu&j ce_da^t i_lle& ca_rmi^ne& i&n te&rra&s ma^go& 	X_^_X_^_X_^X	0.06
Descendat astris Luna desertis licet	de&sce_nda^t a_stri&s lu_na^ de_se&rti&s li^ce&t 	X_^_X_^_X_^X	1.0
Et bruma messes uideat et cantu fugax	e&t bru_ma^ me_sse&s vi^de^a^t e&t ca&ntu_ fu^ga&x 	X_^_X^^^_X_^X	1.0
Stet deprehensum fulmen et uersa uice	ste&t de_pre^he_nsu&m fu_lme^n e&t ve&rsa_ vi^ce& 	X_^_X_^_X_^X	0.94
Medius coactis ferueat stellis dies:	me^di^u&s co^a_cti&s fe_rve^a&t ste&lli&s di^e&s 	^^_^_X_^_X_^X	1.0
Non flectet illum. Vicit et superos Amor.	no&n fle_cte^t i_llu&m vi_ci^t e&t su^pe^ro_s a^mo&r 	X_^_X_^_^^_^X	1.0
Vincetur uni forsan et spolium dabit	vi&nce_tu^r u_ni& fo_rsa^n e&t spo^li^u&m da^bi&t 	X_^_X_^_^^_^X	1.0
Amorque summus fiet Alcidae labor.	a&mo_rqve^ su_mmu&s fi_e^t a_lci&d[ae] la^bo&r 	X_^_X_^_X_^X	0.97
Sed te per omne caelitum numen precor,	se&d te_ pe^r o_mne& c[ae]li^tu_m nu&me&n pre^co&r 	X_^_X_^_X_^X	1.0
Per hunc timorem: quidquid arcani apparo	pe&r hu&nc ti^mo_re&m qvi_dqvi^d a_rca&ni& a_ppa^ro& 	X_^_X_^_X_^X	1.0
Penitus recondas et fide tacita premas.	pe^ni^tu&s re^co_nda&s e&t fi^de_ ta^ci^ta& pre^ma&s	^^_^_X_^_^^_^X	m
Quid istud est quod esse secretum petis?	qvi&d i_stu^d e&st qvo&d e_sse^ se_cre&tu&m pe^ti&s 	X_^_X_^_X_^X	1.0
Non tela sunt, non arma, non ignis minax.	no&n te_la^ su&nt no&n a_rma^ no_n i&gni&s mi^na&x 	X_^_X_^_X_^X	1.0
Praestare fateor posse me tacitam fidem,	pr[ae]sta_re^ fa^te^o&r po_sse^ me_ ta^ci^ta&m fi^de&m 	X_^^^X_^_^^_^X	1.0
Si scelere careat: interim scelus est fides.	si& sce^le^re^ ca^re^a&t i_nte^ri_m sce^lu^s e&st fi^de&s 	X^^^^^X_^_^^_^X	1.0
Circumspice agedum, ne quis arcana occupet,	ci&rcu_mspi^ce& a^ge^du&m ne& qvi^s a_rca&na& o_ccu^pe&t 	X_^^^X_^_X_^X	0.76
Partemque in omnem uultus inquirens eat.	pa&rte_mqve& i^n o_mne&m vu_ltu^s i_nqvi&re_ns e^a&t 	X_^_X_^_X_^X	0.35
En locus ab omni tutus arbitrio uacat.	e&n lo^cu^s a^b o_mni& tu_tu^s a_rbi^tri^o_ va^ca&t 	X^^^_X_^_^^_^X	1.0
Est in remoto regiae sedis loco	e&st i&n re^mo_to& re_gi^[ae] se&di&s lo^co& 	X_^_X_^_X_^X	1.0
Arcana tacitus nostra defendens specus.	a&rca_na^ ta^ci^tu&s no_stra^ de_fe&nde&ns spe^cu&s 	X_^^^X_^_X_^X	1.0
Non ille primos accipit soles locus,	no&n i_lle^ pri_mo&s a_cci^pi&t so&le&s lo^cu&s 	X_^_X_^_X_^X	1.0
Non ille seros, cum ferens Titan diem	no&n i_lle^ se_ro&s cu&m fe^re&ns ti&ta&n di^e&m 	X_^_X_^_X_^X	1.0
Lassam rubenti mergit Oceano rotam.	la&ssa&m ru^be_nti& me_rgi^t o_ce^a^no_ ro^ta&m 	X_^_X_^_^^_^X	1.0
Illic amoris pignus Herculei latet.	i&lli_c a^mo_ri&s pi_gnu^s he_rcu^le^i_ la^te&t 	X_^_X_^_^^_^X	1.0
Altrix, fatebor: auctor est Nessus mali	a&ltri&x fa^te_bo&r [au]cto^r e&st ne&ssu&s ma^li& 	X_^_X_^_X_^X	0.82
Quem grauida Nephele Thessalo genuit duci,	qve&m gra^vi^da^ ne^phe^le& the_ssa^lo_ ge^nu^i&t du^ci&	X^^^^^X_^_^^_^X	m
Qua gelidus astris inserit Pindus caput	qva& ge^li^du^s a_stri&s i_nse^ri&t pi&ndu&s ca^pu&t 	X^^^_X_^_X_^X	1.0
Vltraque nubes Othrys eductus riget.	u&ltra_qve^ nu_be&s o_thry^s e_du&ctu&s ri^ge&t 	X_^_X_^_X_^X	1.0
Namque ut subactus Herculis claua horridi	na&mqve& u&t su^ba_ctu&s he_rcu^li&s cl[au]a& ho_rri^di& 	X_^_X_^_X_^X	1.0
Achelous omnis facilis in species dari	a^che^lo_u^s o_mni&s fa^ci^li^s i&n spe^ci^e&s da^ri& 	^^_^_X^^^_^^_^X	1.0
Tandem peractis omnibus patuit feris	ta&nde&m pe^ra_cti&s o_mni^bu&s pa^tu^i&t fe^ri&s 	X_^_X_^_^^_^X	1.0
Vnoque turpe subdidit cornu caput,	u&no_qve^ tu_rpe& su_bdi^di&t co&rnu_ ca^pu&t 	X_^_X_^_X_^X	1.0
Me coniugem dum uictor Alcides habet,	me& co_nju^ge&m du&m vi_cto^r a_lci&de_s ha^be&t 	X_^_X_^_X_^X	1.0
Repetebat Argos. forte per campos uagus	re^pe^te_ba^t a_rgo&s fo_rte^ pe&r ca&mpo&s va^gu&s 	^^_^_X_^_X_^X	1.0
Euenos altum gurgitem in pontum ferens	[eu]e_no^s a_ltu&m gu_rgi^te&m i&n po&ntu&m fe^re&ns 	X_^_X_^_X_^X	1.0
Iam paene summis turbidus ripis erat.	ja&m p[ae]ne^ su_mmi&s tu_rbi^du&s ri&pi_s e^ra&t 	X_^_X_^_X_^X	1.0
Transire Nessus uerticem solitus uadis	tra&nsi_re^ ne_ssu&s ve_rti^ce&m so^li^tu&s va^di&s	X_^_X_^_^^_^X	m
Pretium poposcit; meque iam dorso ferens	pre^ti^u&m po^po_sci&t me_qve^ ja&m do&rso_ fe^re&ns 	^^_^_X_^_X_^X	1.0
Qua iungit hominem spina deficiens equo,	qva& ju_ngi^t ho^mi^ne&m spi_na^ de_fi^ci^e&ns e^qvo& 	X_^^^X_^_^^_^X	1.0
Frangebat ipsas fluminis tumidi minas.	fra&nge_ba^t i_psa&s flu_mi^ni&s tu^mi^di_ mi^na&s 	X_^_X_^_^^_^X	1.0
Iam totus undis Nessus exierat ferox	ja&m to_tu^s u_ndi&s ne_ssu^s e_xi^e^ra&t fe^ro&x 	X_^_X_^_^^_^X	1.0
Medioque adhuc errabat Alcides uado,	me^di^o_qve& a^dhu_c e&rra_ba^t a_lci&de&s va^do& 	^^_^_X_^_X_^X	0.87
Vasto rapacem uerticem scindens gradu;	va&sto_ ra^pa_ce&m ve_rti^ce&m sci&nde&ns gra^du& 	X_^_X_^_X_^X	1.0
At ille, ut esse uidit Alciden procul:	a&t i_lle& u^t e_sse& vi_di^t a_lci&de&n pro^cu&l 	X_^_X_^_X_^X	1.0
"Tu praeda nobis" inquit "et coniunx eris;	tu& pr[ae]da^ no_bi&s i_nqvi^t e&t co&nju&nx e^ri&s 	X_^_X_^_X_^X	1.0
Prohibetur undis", meque complexu ferens	pro^hi^be_tu^r u_ndi&s me_qve^ co_mple&xu_ fe^re&ns	^^_^_X_^_X_^X	m
Gressum citabat. non tenent undae Herculem:	gre&ssu&m ci^ta_ba&t no&n te^ne&nt u&nd[ae] he_rcu^le&m 	X_^_X_^_X_^X	1.0
"Infide uector" inquit, "immixti licet	i&nfi_de^ ve_cto&r i_nqvi^t i_mmi&xti_ li^ce&t 	X_^_X_^_X_^X	1.0
Ganges et Hister uallibus iunctis eant,	ga&nge_s e^t hi_ste&r va_lli^bu&s ju&ncti_s e^a&nt 	X_^_X_^_X_^X	1.0
Vincemus ambos, consequar telo fugam."	vi&nce_mu^s a_mbo&s co_nse^qva&r te&lo_ fu^ga&m 	X_^_X_^_X_^X	1.0
Praecessit arcus uerba; tum longum ferens	pr[ae]ce_ssi^t a_rcu&s ve_rba^ tu&m lo&ngu&m fe^re&ns 	X_^_X_^_X_^X	1.0
Harundo uulnus tenuit haerentem fugam	ha&ru_ndo^ vu_lnu&s te^nu^i^t h[ae]re&nte&m fu^ga&m 	X_^_X^^^_X_^X	1.0
Mortemque fixit. ille, iam quaerens diem,	mo&rte_mqve^ fi_xi&t i_lle^ ja&m qv[ae]re&ns di^e&m 	X_^_X_^_X_^X	1.0
Tabem fluentis uulneris dextra excipit	ta&be&m flu^e_nti&s vu_lne^ri&s de&xtra& e_xci^pi&t 	X_^_X_^_X_^X	1.0
Traditque nobis ungulae insertam suae,	tra&di_tqve^ no_bi&s u_ngu^lae& i_nse&rta&m su^[ae] 	X_^_X_^_X_^X	1.0
Quam forte saeua sciderat auolsam manu.	qva&m fo_rte^ s[ae]va& sci^de^ra^t [au]o&lsa&m ma^nu& 	X_^_X^^^_X_^X	1.0
Tunc uerba moriens addit: "hoc" inquit "magae	tu&nc ve_rba^ mo^ri^e&ns a_ddi^t ho_c i&nqvi&t ma^gae& 	X_^^^X_^_X_^X	1.0
Dixere amorem posse defigi malo;	di&xe_re& a^mo_re&m po_sse^ de_fi&gi_ ma^lo& 	X_^_X_^_X_^X	0.5
Hoc docta Mycale Thessalas docuit nurus,	ho&c do_cta^ my^ca^le& the_ssa^la_s do^cu^i&t nu^ru&s 	X_^^^X_^_^^_^X	1.0
Vnam inter omnis Luna quam sequitur magas	u&na&m i_nte^r o_mni&s lu_na^ qva&m se^qvi^tu&r ma^ga&s 	X_^_X_^_^^_^X	1.0
Astris relictis. inlitas uestes dabis	a&stri&s re^li_cti&s i_nli^ta&s ve&ste&s da^bi&s 	X_^_X_^_X_^X	1.0
Hac" inquit "ipsa tabe, si paelex tuos	ha&c i_nqvi^t i_psa& ta_be^ si_ p[ae]le&x tu^o&s 	X_^_X_^_X_^X	1.0
Inuisa thalamos tulerit et coniunx leuis	i&nvi_sa^ tha^la^mo&s tu^le^ri^t e&t co&nju&nx le^vi&s 	X_^^^X^^^_X_^X	0.9
Aliam parenti dederit altisono nurum.	a^li^a&m pa^re_nti& de^de^ri^t a_lti^so^no_ nu^ru&m	^^_^_X^^^_^^_^X	m
Hoc nulla lux conspiciat, hoc tenebrae tegant	ho&c nu_lla^ lu&x co&nspi^ci^a^t ho&c te^ne^br[ae] te^ga&nt 	X_^_X^^^_^^_^X	0.38
Tantum remotae: sic potens uires suas	ta&ntu&m re^mo_t[ae] si&c po^te&ns vi&re&s su^a&s 	X_^_X_^_X_^X	1.0
Sanguis tenebit." uerba deprendit quies	sa&ngvi&s te^ne_bi&t ve_rba^ de_pre&ndi&t qvi^e&s 	X_^_X_^_X_^X	1.0
Mortemque lassis intulit membris sopor.	mo&rte_mqve^ la_ssi&s i_ntu^li&t me&mbri&s so^po&r 	X_^_X_^_X_^X	1.0
Tu, quam meis admittit arcanis fides,	tu& qva&m me^i_s a&dmi_tti^t a_rca&ni&s fi^de&s 	X_^_X_^_X_^X	1.0
Perge ut nitentem uirus in uestem datum	pe&rge& u&t ni^te_nte&m vi_ru^s i&n ve&ste&m da^tu&m 	X_^_X_^_X_^X	0.44
Mentem per artus adeat et tacitum intumas	me&nte&m pe^r a_rtu&s a^de^a^t e&t ta^ci^tu&m i_ntu^ma&s 	X_^_X^^^_^^_^X	1.0
Intret medullas. Ocius iussa exsequar,	i&ntre&t me^du_lla&s o_ci^u&s ju&ssa& e_xse^qva&r 	X_^_X_^_X_^X	1.0
Alumna, precibus tu deum inuictum aduoca,	a&lu_mna^ pre^ci^bu&s tu_ de^u&m i_nvi&ctu&m a_dvo^ca& 	X_^^^X_^_X_^X	1.0
Qui certa tenera tela dimittit manu.	qvi& ce_rta^ te^ne^ra& te_la^ di_mi&tti&t ma^nu& 	X_^^^X_^_X_^X	1.0
Te te precor, quem mundus et superi timent	te& te& pre^co&r qve&m mu_ndu^s e&t su^pe^ri_ ti^me&nt 	X_^_X_^_^^_^X	1.0
Et aequor et qui fulmen Aetnaeum quatit,	e&t [ae]qvo^r e&t qvi& fu_lme^n [ae]tn[ae]u&m qva^ti&t 	X_^_X_^_X_^X	0.94
Timende matri teliger saeuae puer:	ti&me_nde^ ma_tri& te_li^ge_r s[ae]v[ae] pu^e&r 	X_^_X_^_X_^X	1.0
Intende certa spiculum uelox manu,	i&nte_nde^ ce_rta& spi_cu^lu&m ve&lo&x ma^nu& 	X_^_X_^_X_^X	1.0
Non ex sagittis leuibus: e numero, precor,	no&n e&x sa^gi_tti&s le^vi^bu^s e_ nu^me^ro& pre^co&r 	X_^_X^^^_^^_^X	0.89
Grauiore prome quod tuae nondum manus	gra^vi^o_re^ pro_me& qvo&d tu^[ae] no&ndu&m ma^nu&s 	^^_^_X_^_X_^X	1.0
Misere in aliquem; non leui telo est opus,	mi&se_re& i^n a^li^qve&m no&n le^vi_ te&lo& e&st o^pu&s 	X_^^^X_^_X_^X	0.89
Vt amare possit Hercules. rigidas manus	u^t a^ma_re^ po_ssi&t he_rcu^le&s ri^gi^da&s ma^nu&s 	^^_^_X_^_^^_^X	1.0
Intende et arcum cornibus iunctis para.	i&nte_nde& e^t a_rcu&m co_rni^bu&s ju&ncti&s pa^ra& 	X_^_X_^_X_^X	1.0
Nunc, nunc sagittam prome qua quondam horridus	nu&nc nu&nc sa^gi_tta&m pro_me^ qva_ qvo&nda&m ho_rri^du&s 	X_^_X_^_X_^X	1.0
Iouem petisti, fulmine abiecto deus	jo&ve&m pe^ti_sti& fu_lmi^ne& a_bje&cto_ de^u&s 	X_^_X_^_X_^X	1.0
Cum fronte subita tumuit et rabidum mare	cu&m fro_nte^ su^bi^ta& tu^mu^i^t e&t ra^bi^du&m ma^re&	X_^^^X^^^_^^_^X	m
Taurus puellae uector Assyriae scidit;	t[au]ru&s pu^e_ll[ae] ve_cto^r a_ssy^ri^[ae] sci^di&t 	X_^_X_^_^^_^X	1.0
Immitte amorem, uincat exempla omnia:	i&mmi_tte& a^mo_re&m vi_nca^t e_xe&mpla& o_mni^a& 	X_^_X_^_X_^X	1.0
Amare discat coniuges. si quas decor	a&ma_re^ di_sca&t co_nju^ge&s si& qva&s de^co&r 	X_^_X_^_X_^X	1.0
Ioles inussit pectori Herculeo faces,	i^o^le_s i^nu_ssi&t pe_cto^ri& he_rcu^le^o_ fa^ce&s 	^^_^_X_^_^^_^X	0.98
Extingue totas, perbibat formam mei.	e&xti_ngve^ to_ta&s pe_rbi^ba&t fo&rma&m me^i& 	X_^_X_^_X_^X	1.0
Tu fulminantem saepe domuisti Iouem,	tu& fu_lmi^na_nte&m s[ae]pe^ do^mu^i&sti_ jo^ve&m 	X_^_X_^^^X_^X	1.0
Tu furua nigri sceptra gestantem poli,	tu& fu_rva^ ni_gri& sce_ptra^ ge_sta&nte&m po^li& 	X_^_X_^_X_^X	1.0
Turbae ducem maioris et dominum Stygis,	tu&rb[ae] du^ce&m ma&jo_ri^s e&t do^mi^nu&m sty^gi&s 	X_^_X_^_^^_^X	1.0
Tuque, o nouerca grauior irata deus,	tu&qve& o_ no^ve_rca& gra^vi^o^r i_ra&ta_ de^u&s 	X_^_X^^^_X_^X	1.0
Cape hunc triumphum: solus euince Herculem.	ca&pe& hu&nc tri^u_mphu&m so_lu^s [eu]i&nce& he_rcu^le&m 	X_^_X_^_X_^X	1.0
Prolata uis est quaeque Palladia colu	pro&la_ta^ vi_s e&st qv[ae]qve^ pa_lla^di^a_ co^lu&	X_^_X_^_^^_^X	m
Lassauit omnem texta famularem manum.	la&ss[au]i^t o_mne&m te_xta^ fa^mu^la&re&m ma^nu&m 	X_^_X_^^^X_^X	1.0
Nunc ingeratur uirus et uestis bibat	nu&nc i_nge^ra_tu&r vi_ru^s e&t ve&sti&s bi^ba&t 	X_^_X_^_X_^X	1.0
Herculea pestem; precibus augebo malum.	he&rcu^le^a^ pe_ste&m pre^ci^bu^s [au]ge&bo_ ma^lu&m 	X^^^_X^^^_X_^X	0.72
In tempore ipso nauus occurrit Lichas:	i&n te_mpo^re& i_pso& n[au]u^s o_ccu&rri&t li^cha&s 	X_^_X_^_X_^X	1.0
Celanda uis est dira, ne pateant doli.	ce&la_nda^ vi_s e&st di_ra^ ne_ pa^te^a&nt do^li& 	X_^_X_^_^^_^X	1.0
O quod superbae non habent umquam domus,	o& qvo&d su^pe_rb[ae] no_n ha^be&nt u&mqva&m do^mu&s 	X_^_X_^_X_^X	1.0
Fidele semper regibus nomen Licha,	fi&de_le^ se_mpe&r re_gi^bu&s no&me&n li^cha& 	X_^_X_^_X_^X	1.0
Cape hos amictus, nostra quos neuit manus,	ca&pe& ho_s a^mi_ctu&s no_stra^ qvo&s n[eu]i&t ma^nu&s 	X_^_X_^_X_^X	1.0
Dum uagus in orbe fertur et uictus mero	du&m va^gu^s i^n o_rbe& fe_rtu^r e&t vi&ctu&s me^ro& 	X^^^_X_^_X_^X	1.0
Tenet feroci Lydiam gremio nurum,	te&ne&t fe^ro_ci& ly_di^a_m gre^mi^o_ nu^ru&m 	X_^_X_^_^^_^X	1.0
Dum poscit Iolen. sed iecur fors horridum	du&m po_sci^t i^o^le&n se&d je^cu&r fo&rs ho_rri^du&m 	X_^^^X_^_X_^X	1.0
Flectam merendo: merita uicerunt malos.	fle&cta&m me^re_ndo& me^ri^ta^ vi_ce&ru&nt ma^lo&s 	X_^_X^^^_X_^X	0.5
Non ante coniunx induat uestes iube	no&n a_nte^ co_nju&nx i_ndu^a&t ve&ste&s ju^be& 	X_^_X_^_X_^X	1.0
Quam ture flammas pascat et placet deos,	qva&m tu_re^ fla_mma&s pa_sca^t e&t pla&ce&t de^o&s 	X_^_X_^_X_^X	1.0
Cana rigentem populo cinctus comam.	ca&na_ ri^ge_nte&m po_pu^lo_ ci_nctu&s co^ma&m. 	X_^_X_^_X_^X	m
Ipsa ad penates regios gressus feram	i&psa& a&d pe^na_te&s re_gi^o&s gre&ssu&s fe^ra&m 	X_^_X_^_X_^X	1.0
Precibusque Amoris horridi matrem colam.	pre^ci^bu_sqve& a^mo_ri&s ho_rri^di_ ma&tre&m co^la&m 	^^_^_X_^_X_^X	1.0
Vos, quas paternis extuli comites focis,	vo&s qva&s pa^te_rni&s e_xtu^li_ co^mi^te&s fo^ci&s	X_^_X_^_^^_^X	m
Calydoniae, lugete deflendam uicem.	ca^ly^do_ni^[ae] lu&ge_te^ de_fle&nda&m vi^ce&m	^^_^_X_^_X_^X	m
Vagus per artus errat excussos tremor,	va&gu&s pe^r a_rtu&s e_rra^t e_xcu&sso&s tre^mo&r 	X_^_X_^_X_^X	1.0
Erectus horret crinis, impulsis adhuc	e&re_ctu^s ho_rre&t cri_ni^s i_mpu&lsi_s a^dhu&c 	X_^_X_^_X_^X	0.56
Stat terror animis et cor attonitum salit	sta&t te_rro^r a^ni^mi&s e&t co^r a_tto^ni^tu&m sa^li&t 	X_^^^X_^_^^_^X	1.0
Pauidumque trepidis palpitat uenis iecur.	pa^vi^du_mqve^ tre^pi^di&s pa_lpi^ta&t ve&ni&s je^cu&r 	^^_^^^X_^_X_^X	1.0
Vt fractus austro pontus etiamnum tumet,	u&t fra_ctu^s [au]stro& po_ntu^s e^ti^a&mnu&m tu^me&t 	X_^_X_^^^X_^X	1.0
Quamuis quiescat languidis uentis dies,	qva&mvi&s qvi^e_sca&t la_ngvi^di&s ve&nti&s di^e&s 	X_^_X_^_X_^X	1.0
Ita mens adhuc uexatur excusso metu.	i^ta^ me&ns a^dhu&c ve&xa_tu^r e_xcu&sso_ me^tu& 	^^_^_X_^_X_^X	1.0
Semel profecto premere felices deus	se&me&l pro^fe_cto& pre^me^re^ fe_li&ce&s de^u&s 	X_^_X^^^_X_^X	1.0
Cum coepit, urget. hos habent magna exitus.	cu&m c[oe]pi^t u_rge&t ho_s ha^be&nt ma&gna& e_xi^tu&s 	X_^_X_^_X_^X	1.0
Quis tam impotens, miseranda, te casus rotat?	qvi&s ta&m i_mpo^te_ns mi^se^ra_nda^ te_ ca&su&s ro^ta&t 	X_^_^^_^_X_^X	1.0
Vt missa palla est tabe Nessea inlita	u&t mi_ssa^ pa_lla& e&st ta_be^ ne_sse&a& i_nli^ta& 	X_^_X_^_X_^X	1.0
Thalamisque maerens intuli gressum meis,	tha^la^mi_sqve^ m[ae]re&ns i_ntu^li& gre&ssu&m me^i&s 	^^_^_X_^_X_^X	1.0
Libet experiri. solibus uirus ferum	li^be^t e_xpe^ri_ri& so_li^bu&s vi&ru&s fe^ru&m 	^^_^_X_^_X_^X	1.0
Flammisque Nessus sanguinem ostendi arcuit:	fla&mmi_sqve^ ne_ssu&s sa_ngvi^ne&m o_ste&ndi& a_rcu^i&t 	X_^_X_^_X_^X	1.0
Hic ipse fraudes esse praemonuit dolus.	hi&c i_pse^ fr[au]de&s e_sse^ pr[ae]mo^nu^i&t do^lu&s 	X_^_X_^_^^_^X	1.0
Et forte, nulla nube respersus iubar,	e&t fo_rte^ nu_lla& nu_be^ re_spe&rsu&s ju^ba&r 	X_^_X_^_X_^X	1.0
Laxabat ardens feruidum Titan diem	la&xa_ba^t a_rde&ns fe_rvi^du&m ti&ta&n di^e&m 	X_^_X_^_X_^X	1.0
(Vix ora solui patitur etiamnunc timor)	vi&x o_ra^ so_lvi& pa^ti^tu^r e^ti^a&mnu&nc ti^mo&r 	X_^_X^^^^^X_^X	1.0
Medios in ignes solis et claram facem,	me^di^o_s i^n i_gne&s so_li^s e&t cla&ra&m fa^ce&m 	^^_^_X_^_X_^X	0.86
Quo tincta fuerat palla uestisque inlita,	qvo& ti_ncta^ fu^e^ra&t pa_lla^ ve_sti&sqve& i_nli^ta& 	X_^^^X_^_X_^X	1.0
Abiectus horret uillus et Phoebi coma	a&bje_ctu^s ho_rre&t vi_llu^s e&t ph[oe]bi_ co^ma& 	X_^_X_^_X_^X	1.0
Tepefactus arsit (uix queo monstrum eloqui)	te^pe^fa_ctu^s a_rsi&t vi&x qve^o_ mo&nstru&m e_lo^qvi& 	^^_^_X_^_X_^X	1.0
Niues ut Eurus soluit aut tepidus Notus,	ni&ve_s u^t [eu]ru&s so_lvi^t [au]t te^pi^du&s no^tu&s 	X_^_X_^_^^_^X	0.55
Quas uere primo lucidus perdit Mimas,	qva&s ve_re^ pri_mo& lu_ci^du&s pe&rdi&t mi^ma&s 	X_^_X_^_X_^X	0.88
Vtque euolutos frangit Ionio salo	u&tqve& e_vo^lu_to&s fra_ngi^t i_o^ni^o_ sa^lo& 	X_^_X_^_^^_^X	1.0
Opposita fluctus Leucas et lassus tumor	o&ppo^si^ta^ flu_ctu&s l[eu]ca^s e&t la&ssu&s tu^mo&r 	X^^^_X_^_X_^X	1.0
In litore ipso spumat, aut caelestibus	i&n li_to^re& i_pso& spu_ma^t [au]t c[ae]le_sti^bu&s 	X_^_X_^_X_^X	1.0
Aspersa tepidis tura laxantur focis,	a&spe_rsa^ te^pi^di&s tu_ra^ la_xa&ntu&r fo^ci&s 	X_^^^X_^_X_^X	1.0
Sic languet omne uellus et perdit comas.	si&c la_ngve^t o_mne& ve_llu^s e&t pe&rdi&t co^ma&s 	X_^_X_^_X_^X	1.0
Dumque ista miror, causa mirandi perit;	du&mqve& i_sta^ mi_ro&r c[au]sa^ mi_ra&ndi_ pe^ri&t 	X_^_X_^_X_^X	1.0
Quin ipsa tellus spumeos motus agit	qvi&n i_psa^ te_llu&s spu_me^o&s mo&tu_s a^gi&t 	X_^_X_^_X_^X	0.43
Et quidquid illa tabe contactum est labat	e&t qvi_dqvi^d i_lla& ta_be^ co_nta&ctu&m e&st la^ba&t 	X_^_X_^_X_^X	1.0
Natum pauentem cerno et ardenti pede	na&tu&m pa^ve_nte&m ce_rno& e^t a_rde&nti_ pe^de& 	X_^_X_^_X_^X	1.0
Gressus ferentem. prome quid portes noui.	gre&ssu&s fe^re_nte&m pro_me^ qvi&d po&rte&s no^vi& 	X_^_X_^_X_^X	0.64
I, profuge, quaere si quid ulterius patet	i& pro^fu^ge^ qv[ae]re& si& qvi^d u_lte^ri^u&s pa^te&t 	X^^^_X_^_^^_^X	1.0
Terris freto sideribus Oceano inferis:	te&rri&s fre^to_ si&de^ri^bu^s o_ce^a^no& i_nfe^ri&s 	X_^_X^^^_^^_^X	1.0
Vltra labores, mater, Alcidae fuge.	u&ltra_ la^bo_re&s ma_te^r a_lci&d[ae] fu^ge& 	X_^_X_^_X_^X	1.0
Nescio quod animus grande praesagit malum.	ne&sci^o^ qvo^d a^ni^mu&s gra_nde^ pr[ae]sa&gi&t ma^lu&m 	X^^^^^X_^_X_^X	0.72
Plenae triumphi templa Iunonis pete:	ple&n[ae] tri^u_mphi& te_mpla^ ju_no&ni&s pe^te& 	X_^_X_^_X_^X	1.0
Haec tibi patent, delubra praeclusa omnia.	h[ae]c ti^bi^ pa^te&nt de&lu_bra^ pr[ae]clu&sa& o_mni^a& 	X^^^_X_^_X_^X	0.84
Effare quis me casus insontem premat.	e&ffa_re^ qvi&s me& ca_su^s i_nso&nte&m pre^ma&t 	X_^_X_^_X_^X	0.39
Decus illud orbis atque praesidium unicum,	de^cu^s i_llu^d o_rbi&s a_tqve^ pr[ae]si^di^u&m u_ni^cu&m 	^^_^_X_^_^^_^X	0.99
Quem fata terris in locum dederant Iouis,	qve&m fa_ta^ te_rri&s i&n lo^cu&m de^de^ra&nt jo^vi&s 	X_^_X_^_^^_^X	1.0
O mater, abiit: membra et Herculeos toros	o& ma_te^r a^bi^i&t me_mbra& e^t he_rcu^le^o&s to^ro&s 	X_^^^X_^_^^_^X	1.0
Vrit lues nescio qua; qui domuit feras,	u&ri&t lu^e&s ne&sci^o^ qva^ qvi_ do^mu^i&t fe^ra&s 	X_^_X^^^_^^_^X	1.0
Ille ille uictor uincitur maeret dolet.	i&lle& i_lle^ vi_cto&r vi_nci^tu&r m[ae]re&t do^le&t 	X_^_X_^_X_^X	1.0
Quid quaeris ultra? Miserias properant suas	qvi&d qv[ae]ri^s u_ltra& mi^se^ri^a&s pro^pe^ra&nt su^a&s	X_^_X^^^_^^_^X	m
Audire miseri; fare, quo posita in statu	[au]di_re^ mi^se^ri& fa_re^ qvo_ po^si^ta& i&n sta^tu& 	X_^^^X_^_^^_^X	1.0
Iam nostra domus est? o lares, miseri lares!	ja&m no_stra^ do^mu^s e&st o_ la^re&s mi^se^ri_ la^re&s 	X_^^^X_^_^^_^X	0.83
Nunc uidua, nunc expulsa, nunc ferar obruta.	nu&nc vi^du^a^ nu&nc e&xpu_lsa^ nu&nc fe^ra^r o_bru^ta& 	X^^^_X_^_^^_^X	0.67
Non sola maeres Herculem: toto iacet	no&n so_la^ me_re&s he_rcu^le_m to&to_ ja^ce&t 	X_^_X_^_X_^X	0.97
Mundo gemendus; fata nec, mater, tua	mu&ndo_ ge^me_ndu&s fa_ta^ ne&c ma&te&r tu^a& 	X_^_X_^_X_^X	1.0
Priuata credas: iam genus totum obstrepit.	pri&va_ta^ cre_da&s ja&m ge^nu&s to&tu&m o_bstre^pi&t 	X_^_X_^_X_^X	1.0
Hunc ecce luctum quem gemis cuncti gemunt;	hu&nc e_cce^ lu_ctu&m qve&m ge^mi&s cu&ncti_ ge^mu&nt 	X_^_X_^_X_^X	1.0
Commune terris omnibus pateris malum.	co&mmu_ne^ te_rri&s o_mni^bu&s pa^te^ri&s ma^lu&m 	X_^_X_^_^^_^X	0.72
Luctum occupasti: prima, non sola Herculem,	lu&ctu&m o_ccu^pa_sti& pri_ma^ no&n so&la& he_rcu^le&m 	X_^_X_^_X_^X	1.0
Miseranda, maeres. Quam prope a leto tamen	mi^se^ra_nda^ me_re&s qva&m pro^pe& a_ le&to_ ta^me&n 	^^_^_X_^_X_^X	1.0
Ede, ede quaeso iaceat Alcides meus.	e&de& e_de^ qv[ae]so& ja^ce^a^t a_lci&de&s me^u&s 	X_^_X^^^_X_^X	1.0
Mors refugit illum uicta quae in regno suo	mo&rs re^fu^gi^t i_llu&m vi_cta^ qv[ae] i&n re&gno& su^o& 	X^^^_X_^_X_^X	0.15
Semel est nec audent fata tam uastum nefas	se^me^l e&st ne^c [au]de&nt fa_ta^ ta&m va&stu&m ne^fa&s 	^^_^_X_^_X_^X	1.0
Admittere. ipsa forsitan trepida colus	a&dmi_tte^re& i_psa& fo_rsi^ta&n tre^pi^da_ co^lu&s	X_^_X_^_^^_^X	m
Clotho manu proiecit et fata Herculis	clo&tho_ ma^nu& pro&je_ci^t e&t fa&ta& he_rcu^li&s 	X_^_X_^_X_^X	1.0
Timet peragere. pro diem, infandum diem!	ti&me&t pe^ra^ge^re& pro_ di^e&m i_nfa&ndu&m di^e&m 	X_^^^X_^_X_^X	1.0
Hocne ille summo magnus Alcides erit?	ho&cne& i_lle^ su_mmo& ma_gnu^s a_lci&de_s e^ri&t 	X_^_X_^_X_^X	1.0
Ad fata et umbras atque peiorem polum	a&d fa_ta& e^t u_mbra&s a_tqve^ p[ei]o&re&m po^lu&m 	X_^_X_^_X_^X	0.99
Praecedere illum dicis? an possum prior	pr[ae]ce_de^re& i_llu&m di_ci^s a&n po&ssu&m pri^o&r 	X_^_X_^_X_^X	1.0
Mortem occupare? fare, si nondum occidit.	mo&rte&m o_ccu^pa_re& fa_re^ si_ no&ndu&m o_cci^di&t 	X_^_X_^_X_^X	1.0
Euboica tellus uertice immenso tumens	[eu]bo^i^ca^ te_llu&s ve_rti^ce& i_mme&nso_ tu^me&ns 	X^^^_X_^_X_^X	1.0
Pulsatur omni latere: Phrixeum mare	pu&lsa_tu^r o_mni& la^te^re^ phri_xe&u&m ma^re& 	X_^_X^^^_X_^X	0.86
Scindit Caphereus, seruit hoc Austro latus;	sci&ndi&t ca^phe_r[eu]s se_rvi^t ho_c [au]stro_ la^tu&s 	X_^_X_^_X_^X	0.98
At qua niuosi patitur Aquilonis minas,	a&t qva_ ni^vo_si& pa^ti^tu^r a^qvi^lo&ni&s mi^na&s 	X_^_X^^^^^X_^X	1.0
Euripus undas flectit instabilis uagas	[eu]ri_pu^s u_nda&s fle_cti^t i_nsta^bi^li&s va^ga&s	X_^_X_^_^^_^X	m
Septemque cursus uoluit et totidem refert,	se_pte_mque^ cu_rsu&s uo_lui^t e&t to^ti^de&m re^fe&rt,	X_^_X_^_^^_^X	m
Dum lassa Titan mergit Oceano iuga.	du&m la_ssa^ ti_ta&n me_rgi^t o_ce^a^no_ ju^ga& 	X_^_X_^_^^_^X	1.0
Hic rupe celsa, nulla quam nubes ferit,	hi&c ru_pe^ ce_lsa& nu_lla^ qva&m nu&be&s fe^ri&t 	X_^_X_^_X_^X	1.0
Annosa fulgent templa Cenaei Iouis.	a&nno_sa^ fu_lge&nt te_mpla^ ce_n[ae]i_ jo^vi&s 	X_^_X_^_X_^X	1.0
Vt stetit ad aras omne uotiuum pecus	u&t ste^ti^t a^d a_ra_s o_mne^ vo_ti_vu&m pe^cu&s 	X^^^_X_^_X_^X	m
Totumque tauris gemuit auratis nemus,	to&tu_mqve^ t[au]ri&s ge^mu^i^t [au]ra&ti&s ne^mu&s 	X_^_X^^^_X_^X	1.0
Spolium leonis sordidum tabo exuit	spo^li^u&m le^o_ni&s so_rdi^du&m ta&bo& e_xu^i&t 	^^_^_X_^_X_^X	1.0
Posuitque clauae pondus et pharetra grauis	po^su^i_tqve^ cl[au][ae] po_ndu^s e&t pha^re^tra& gra^vi&s	^^_^_X_^_^^_^X	m
Laxauit umeros. ueste tunc fulgens tua,	la&x[au]i^t u^me^ro&s ve_ste^ tu&nc fu&lge&ns tu^a& 	X_^^^X_^_X_^X	1.0
Cana reuinctus populo horrentem comam,	ca_na_ re^ui_nctu&s po_pu^lo& ho_rre_nte&m co^ma&m, 	X_^_X_^_X_^X	m
Succendit aras: "accipe has" inquit "focis	su&cce_ndi^t a_ra&s a_cci^pe& ha_s i&nqvi&t fo^ci&s 	X_^_X_^_X_^X	1.0
Non false messis genitor et largo sacer	no&n fa_lse^ me_ssi&s ge^ni^to^r e&t la&rgo_ sa^ce&r 	X_^_X^^^_X_^X	0.01
Splendescat ignis ture, quod Phoebum colens	sple&nde_sca^t i_gni&s tu_re^ qvo&d ph[oe]bu&m co^le&ns 	X_^_X_^_X_^X	1.0
Diues Sabaeis colligit truncis Arabs.	di&ve&s sa^b[ae]i&s co_lli^gi&t tru&nci_s a^ra&bs 	X_^_X_^_X_^X	1.0
Pacata tellus" inquit "et caelum et freta,	pa&ca_ta^ te_llu&s i_nqvi^t e&t c[ae]lu&m e&t fre^ta& 	X_^_X_^_X_^X	0.94
Feris subactis omnibus uictor redi:	fe&ri&s su^ba_cti&s o_mni^bu&s vi&cto&r re^di& 	X_^_X_^_X_^X	1.0
Depone fulmen" - gemitus in medias preces	de_po_ne^ fu_lme&n" - ge^mi^tu^s i&n me^di^a&s pre^ce_s 	X_^_X^^^_^^_^X	m
Stupente et ipso cecidit; hinc caelum horrido	stu&pe_nte& e^t i_pso& ce^ci^di^t hi&nc c[ae]lu&m ho_rri^do& 	X_^_X^^^_X_^X	0.97
Clamore complet: qualis impressa fugax	cla&mo_re^ co_mple&t qva_li^s i_mpre&ssa_ fu^ga&x 	X_^_X_^_X_^X	1.0
Taurus bipenni uolnus et telum ferens	t[au]ru&s bi^pe_nni& vo_lnu^s e&t te&lu&m fe^re&ns 	X_^_X_^_X_^X	1.0
Delubra uasto trepida mugitu replet,	de&lu_bra^ va_sto& tre^pi^da^ mu_gi&tu_ re^ple&t 	X_^_X^^^_X_^X	0.83
Aut quale mundo fulmen emissum tonat,	[au]t qva_le^ mu_ndo& fu_lme^n e_mi&ssu&m to^na&t 	X_^_X_^_X_^X	0.94
Sic ille gemitu sidera et pontum ferit,	si&c i_lle^ ge^mi^tu& si_de^ra& e&t po&ntu&m fe^ri&t 	X_^^^X_^_X_^X	1.0
Et uasta Chalcis sonuit et uoces Cyclas	e_t ua_sta^ cha_lci&s so^nu^i^t e_t uo_ce&s cy^cla_s 	X_^_X^^^_X_^X	m
Excepit omnis; hinc petrae Capherides,	e_xce_pi^t o_mni&s; hi&nc pe^tr[ae] ca&phe_ri^de&s, 	X_^_X_^_X_^X	m
Hinc omne uoces reddit Herculeas nemus.	hi&nc o_mne^ vo_ce&s re_ddi^t he_rcu^le^a&s ne^mu&s 	X_^_X_^_^^_^X	0.99
Flentem uidemus. uulgus antiquam putat	fle&nte&m vi^de_mu&s vu_lgu^s a_nti&qva&m pu^ta&t 	X_^_X_^_X_^X	1.0
Rabiem redisse; tunc fugam famuli petunt.	ra^bi^e&m re^di_sse& tu&nc fu^ga&m fa^mu^li_ pe^tu&nt 	^^_^_X_^_^^_^X	1.0
At ille uoltus ignea torquens face	a&t i_lle^ vo_ltu&s i_gne^a_ to&rqve&ns fa^ce& 	X_^_X_^_X_^X	1.0
Vnum inter omnes sequitur et quaerit Lichan.	u&nu&m i_nte^r o_mne&s se^qvi^tu^r e&t qv[ae]ri&t li^cha&n 	X_^_X^^^_X_^X	1.0
Complexus aras ille tremibunda manu	co&mple_xu^s a_ra&s i_lle^ tre^mi^bu&nda_ ma^nu& 	X_^_X_^^^X_^X	0.86
Mortem metu consumpsit et paruum sui	mo&rte&m me^tu_ co&nsu_mpsi^t e&t pa&rvu&m su^i& 	X_^_X_^_X_^X	1.0
Poenae reliquit. dumque tremibundum manu	p[oe]n[ae] re^li_qvi&t du_mqve^ tre^mi^bu&ndu&m ma^nu& 	X_^_X_^^^X_^X	1.0
Tenuit cadauer: "hac manu, hac" inquit "ferar,	te^nu^i&t ca^d[au]e&r ha&c ma^nu& ha_c i&nqvi&t fe^ra&r 	^^_^_X_^_X_^X	1.0
O fata, uictus? Herculem uicit Lichas?	o& fa_ta^ vi_ctu&s he_rcu^le_m vi&ci&t li^cha&s 	X_^_X_^_X_^X	1.0
Ecce alia clades: Hercules perimit Lichan.	e&cce& a^li^a^ cla_de&s he_rcu^le&s pe^ri^mi&t li^cha&n	X^^^_X_^_^^_^X	m
Facta inquinentur: fiat hic summus labor."	fa&cta& i_nqvi^ne_ntu&r fi_a^t hi&c su&mmu&s la^bo&r 	X_^_X_^_X_^X	0.97
In astra missus fertur et nubes uago	i&n a_stra^ mi_ssu&s fe_rtu^r e&t nu&be&s va^go& 	X_^_X_^_X_^X	1.0
Spargit cruore; talis in caelum exilit	spa&rgi&t cru^o_re& ta_li^s i&n c[ae]lu&m e_xi^li&t 	X_^_X_^_X_^X	0.87
Harundo Getica iussa dimitti manu	ha&ru_ndo^ ge^ti^ca& ju_ssa^ di_mi&tti_ ma^nu& 	X_^^^X_^_X_^X	1.0
Aut quam Cydon excussit: inferius tamen	[au]t qva&m cy^do_n e&xcu_ssi^t i_nfe^ri^u&s ta^me&n 	X_^_X_^_^^_^X	0.8
Et tela fugient. truncus in pontum cadit,	e&t te_la^ fu^gi^e&nt tru_ncu^s i&n po&ntu&m ca^di&t 	X_^^^X_^_X_^X	0.76
In saxa ceruix: unus ambobus iacet.	i&n sa_xa^ ce_rvi&x u_nu^s a_mbo&bu&s ja^ce&t 	X_^_X_^_X_^X	1.0
"Resistite" inquit, "non furor mentem abstulit,	re&si_sti^te& i_nqvi&t no&n fu^ro&r me&nte&m a_bstu^li&t 	X_^_X_^_X_^X	1.0
Furore grauius istud atque ira malum est:	fu&ro_re^ gra^vi^u&s i_stu^d a_tqve& i&ra_ ma^lu&m e&st 	X_^^^X_^_X_^X	0.72
In me iuuat saeuire." uix pestem indicat	i&n me_ ju^va&t s[ae]vi_re^ vi&x pe&ste&m i_ndi^ca&t 	X_^_X_^_X_^X	1.0
Et saeuit: artus ipse dilacerat suos	e&t s[ae]vi^t a_rtu&s i_pse^ di_la^ce^ra&t su^o&s 	X_^_X_^_^^_^X	1.0
Et membra uasta carpit auellens manu.	e&t me_mbra^ va_sta& ca_rpi^t a_ve&lle_ns ma^nu& 	X_^_X_^_X_^X	1.0
Exuere amictus quaerit: hoc solum Herculem	e&xu^e^re& a^mi_ctu&s qv[ae]ri^t ho&c so&lu&m he_rcu^le&m 	X^^^_X_^_X_^X	1.0
Non posse uidi; trahere conatus tamen	no&n po_sse^ vi_di& tra^he^re^ co_na&tu&s ta^me&n 	X_^_X^^^_X_^X	1.0
Et membra traxit: corporis palla horridi	e&t me_mbra^ tra_xi&t co_rpo^ri&s pa&lla& ho_rri^di& 	X_^_X_^_X_^X	1.0
Pars est et ipsa - uestis immiscet cutem.	pa&rs e&st e^t i_psa& ve_sti^s i_mmi&sce&t cu^te&m 	X_^_X_^_X_^X	0.57
Nec causa dirae cladis in medio patet,	ne&c c[au]sa^ di_r[ae] cla_di^s i&n me^di^o_ pa^te&t 	X_^_X_^_^^_^X	1.0
Sed causa tamen est; uixque sufficiens malo	se&d c[au]sa^ ta^me^n e&st vi_xqve^ su_ffi^ci^e&ns ma^lo& 	X_^^^X_^_^^_^X	0.5
Nunc ore terram languidus prono premit,	nu&nc o_re^ te_rra&m la_ngvi^du&s pro&no& pre^mi&t 	X_^_X_^_X_^X	1.0
Nunc poscit undas - unda non uincit malum;	nu&nc po_sci^t u_nda&s u_nda^ no&n vi&nci&t ma^lu&m 	X_^_X_^_X_^X	0.72
Fluctisona quaerit litora et pontum occupat:	flu&cti^so^na^ qv[ae]ri&t li_to^ra& e&t po&ntu&m o_ccu^pa&t 	X^^^_X_^_X_^X	1.0
Famularis illum retinet errantem manus -	fa^mu^la_ri^s i_llu&m re^ti^ne^t e_rra&nte&m ma^nu&s	^^_^_X^^^_X_^X	m
O sortem acerbam! fuimus Alcidae pares.	o& so_rte&m a^ce_rba&m fu^i^mu^s a_lci&d[ae] pa^re&s 	X_^_X^^^_X_^X	1.0
Nunc puppis illum litore Euboico refert	nu&nc pu_ppi^s i_llu&m li_to^re& [eu]bo^i^co_ re^fe&rt 	X_^_X_^_^^_^X	0.82
Austerque lenis pondus Herculeum rapit;	[au]ste_rqve^ le_ni&s po_ndu^s he_rcu^le^u&m ra^pi&t 	X_^_X_^_^^_^X	1.0
Destituit animus membra, nox oculos premit.	de&sti^tu^i^t a^ni^mu&s me_mbra^ no&x o^cu^lo&s pre^mi&t 	X^^^^^X_^_^^_^X	1.0
Quid, anime, cessas? quid stupes? factum est scelus:	qvi&d a^ni^me^ ce_ssa&s qvi&d stu^pe&s fa&ctu&m e&st sce^lu&s 	X^^^_X_^_X_^X	1.0
Natum reposcit Iuppiter, Iuno aemulum;	na&tu&m re^po_sci&t ju_ppi^te&r ju&no& [ae]mu^lu&m 	X_^_X_^_X_^X	1.0
Reddendus orbi est - quod potest reddi, exhibe:	re&dde_ndu^s o_rbi& e&st qvo&d po^te&st re&ddi& e_xhi^be& 	X_^_X_^_X_^X	1.0
Eat per artus ensis exactus meos.	e&a&t pe^r a_rtu&s e_nsi^s e_xa&ctu&s me^o&s 	X_^_X_^_X_^X	0.95
Sic, sic agendum est - tam leuis poenas manus	si&c si_c a^ge_ndu&m e&st ta&m le^vi&s p[oe]na&s ma^nu&s 	X_^_X_^_X_^X	0.9
Tantas reposcit? perde fulminibus, socer,	ta&nta&s re^po_sci&t pe_rde^ fu_lmi^ni^bu&s so^ce&r 	X_^_X_^_^^_^X	1.0
Nurum scelestam. nec leui telo manus	nu&ru&m sce^le_sta&m ne&c le^vi_ te&lo_ ma^nu&s 	X_^_X_^_X_^X	0.96
Armetur: illud fulmen exiliat polo,	a&rme_tu^r i_llu&d fu_lme^n e_xi^li^a_t po^lo& 	X_^_X_^_^^_^X	0.94
Quo, nisi fuisset genitus Alcides tibi,	qvo& ni^si^ fu^i_sse&t ge^ni^tu^s a_lci&de&s ti^bi& 	X^^^_X^^^_X_^X	0.97
Hydram cremasses: pestem ut insolitam feri	hy&dra&m cre^ma_sse&s pe_ste&m u^t i_nso^li^ta&m fe^ri& 	X_^_X_^_^^_^X	1.0
Et ut nouerca peius irata malum.	e&t u&t no^ve_rca& p[ei]u^s i_ra&ta_ ma^lu&m 	X_^_X_^_X_^X	0.72
Emitte telum quale in errantem prius	e&mi_tte^ te_lu&m qva_le& i^n e_rra&nte&m pri^u&s 	X_^_X_^_X_^X	1.0
Phaethonta missum est: perdidi in solo Hercule	pha^e^tho_nta^ mi_ssu&m e&st pe_rdi^di& i&n so&lo& he_rcu^le& 	^^_^_X_^_X_^X	1.0
Et ipsa populos. - quid rogas telum deos?	e&t i_psa^ po^pu^lo&s qvi&d ro^ga&s te&lu&m de^o&s 	X_^^^X_^_X_^X	1.0
Iam parce socero: coniugem Alcidae necem	ja&m pa_rce^ so^ce^ro& co_nju^ge&m a_lci&d[ae] ne^ce&m 	X_^^^X_^_X_^X	0.97
Optare pudeat: haec erit uoto manus,	o&pta_re^ pu^de^a&t h[ae]c e^ri&t vo&to_ ma^nu&s 	X_^^^X_^_X_^X	1.0
A me petatur; occupa ferrum ocius -	a& me_ pe^ta_tu&r o_ccu^pa_ fe&rru&m o_ci^u&s 	X_^_X_^_X_^X	1.0
Cur deinde ferrum? quidquid ad mortem trahit	cu&r d[ei]nde^ fe_rru&m qvi_dqvi^d a&d mo&rte&m tra^hi&t 	X_^_X_^_X_^X	1.0
Telum est abunde: rupe ab aetheria ferar.	te&lu&m e&st a^bu_nde& ru_pe& a^b [ae]the^ri^a_ fe^ra&r	X_^_X_^_^^_^X	m
Haec, haec renatum prima quae noscit diem	h[ae]c h[ae]c re^na_tu&m pri_ma^ qv[ae] no&sci&t di^e&m 	X_^_X_^_X_^X	1.0
Oeta eligatur; corpus hinc mitti placet. -	[oe]ta& e_li^ga_tu&r co_rpu^s hi&nc mi&tti& pla^ce&t 	X_^_X_^_X_^X	0.97
Leuis una mors est - leuis, at extendi potest:	le^vi^s u_na^ mo&rs e&st le^vi^s a^t e_xte&ndi_ po^te&st 	^^_^_X^^^_X_^X	0.81
Abrupta cautes scindat et partem mei	a&bru_pta^ c[au]te&s sci_nda^t e&t pa&rte&m me^i& 	X_^_X_^_X_^X	1.0
Ferat omne saxum, pendeant lacerae manus	fe^ra^t o_mne^ sa_xu&m pe_nde^a&nt la^ce^r[ae] ma^nu&s 	^^_^_X_^_^^_^X	1.0
Totumque rubeat asperi montis latus. -	to&tu_mqve^ ru^be^a&t a_spe^ri_ mo&nti&s la^tu&s 	X_^^^X_^_X_^X	0.98
Eligere nescis, anime, cui telo incubes!	e&li^ge^re^ ne_sci&s a^ni^me^ cu_j te&lo& i_ncu^be&s 	X^^^_X^^^_X_^X	1.0
Vtinam esset, utinam fixus in thalamis meis	u^ti^na&m e_sse^t u^ti^na&m fi_xu^s i&n tha^la^mi&s me^i&s 	^^_^^^X_^_^^_^X	1.0
Herculeus ensis: huic decet ferro inmori. -	he&rcu^le^u^s e_nsi&s hu&jc de^ce&t fe&rro& i_nmo^ri& 	X^^^_X_^_X_^X	1.0
Vna perire dextera nobis sat est?	u&na_ pe^ri_re& de_xte^ra_ no&bi&s sa^t e&st 	X_^_X_^_X_^X	1.0
Coite, gentes, saxa et immensas faces	co&i_te^ ge_nte&s sa_xa& e^t i_mme&nsa&s fa^ce&s 	X_^_X_^_X_^X	0.98
Iaculetur orbis, nulla nunc cesset manus,	ja^cu^le_tu^r o_rbi&s nu_lla^ nu&nc ce&sse&t ma^nu&s	^^_^_X_^_X_^X	m
Corripite tela, uindicem uestrum abstuli:	co&rri^pi^te^ te_la& vi_ndi^ce&m ve&stru&m a_bstu^li& 	X^^^_X_^_X_^X	1.0
Impune saeui sceptra iam reges gerent,	i&mpu_ne^ s[ae]vi& sce_ptra^ ja&m re&ge&s ge^re&nt 	X_^_X_^_X_^X	1.0
Impune iam nascetur indomitum malum;	i&mpu_ne^ ja&m na&sce_tu^r i_ndo^mi^tu&m ma^lu&m 	X_^_X_^_^^_^X	0.72
Reddentur arae cernere assuetae hostiam	re&dde_ntu^r a_r[ae] ce_rne^re& a_ssve&t[ae] ho_sti^a&m 	X_^_X_^_X_^X	1.0
Similem colenti: sceleribus feci uiam;	si^mi^le&m co^le_nti& sce^le^ri^bu_s fe&ci_ vi^a&m 	^^_^_X^^^_X_^X	1.0
Ego uos tyrannis regibus monstris feris	e^go^ vo&s ty^ra_nni&s re_gi^bu&s mo&nstri&s fe^ri&s 	^^_^_X_^_X_^X	1.0
Saeuisque rapto uindice opposui deis. -	s[ae]vi_sqve^ ra_pto& vi_ndi^ce& o_ppo^su^i_ de^i&s 	X_^_X_^_^^_^X	1.0
Cessas, Tonantis socia? non spargis facem	ce&ssa&s to^na_nti&s so^ci^a^ no&n spa&rgi&s fa^ce&m 	X_^_X^^^_X_^X	1.0
Imitata fratrem et mittis ereptam Ioui	i^mi^ta_ta^ fra_tre&m e&t mi_tti^s e_re&pta&m jo^vi& 	^^_^_X_^_X_^X	1.0
Meque ipsa perdis? laus tibi erepta incluta est,	me&qve& i_psa^ pe_rdi&s l[au]s ti^bi& e_re&pta& i_nclu^ta& e&st 	X_^_X_^_X_^X	1.0
Ingens triumphus: aemuli, Iuno, tui	i&nge&ns tri^u_mphu&s [ae]mu^li_ ju&no_ tu^i& 	X_^_X_^_X_^X	0.53
Mortem occupaui. Quid domum impulsam trahis?	mo&rte&m o_ccu^pa_vi& qvi&d do^mu&m i_mpu&lsa&m tra^hi&s 	X_^_X_^_X_^X	1.0
Erroris istic omne quodcumque est nefas.	e&rro_ri^s i_sti&c o_mne^ qvo_dcu&mqve& e&st ne^fa&s 	X_^_X_^_X_^X	1.0
Haut est nocens quicumque non sponte est nocens.	h[au]t e&st no^ce&ns qvi&cu_mqve^ no&n spo&nte& e&st no^ce&ns 	X_^_X_^_X_^X	1.0
Quicumque fato ignoscit et parcit sibi,	qvi&cu_mqve^ fa_to& i&gno_sci^t e&t pa&rci&t si^bi& 	X_^_X_^_X_^X	1.0
Errare meruit: morte damnari placet.	e&rra_re^ me^ru^i&t mo_rte^ da_mna&ri& pla^ce&t 	X_^^^X_^_X_^X	0.97
Nocens uideri, qui mori quaerit, cupit.	no&ce&ns vi^de_ri& qvi_ mo^ri& qv[ae]ri&t cu^pi&t 	X_^_X_^_X_^X	1.0
Mors innocentes sola deceptos facit.	mo&rs i_nno^ce_nte&s so_la^ de_ce&pto&s fa^ci&t 	X_^_X_^_X_^X	0.97
Titana fugies? Ipse me Titan fugit.	ti&ta_na^ fu^gi^e&s i_pse^ me_ ti&ta&n fu^gi&t	X_^^^X_^_X_^X	m
Vitam relinques? Miseram, ut Alciden sequar.	vi&ta&m re^li_nqve&s mi^se^ra&m u^t a_lci&de&n se^qva&r 	X_^_X^^^_X_^X	1.0
Superest et auras ille caelestes trahit.	su^pe^re&st e^t [au]ra&s i_lle^ c[ae]le&ste&s tra^hi&t 	^^_^_X_^_X_^X	1.0
Vinci Hercules cum potuit, hinc coepit mori.	vi&nci& he_rcu^le&s cu&m po^tu^i^t hi&nc c[oe]pi&t mo^ri& 	X_^_X^^^_X_^X	1.0
Natum relinques fataque abrumpes tua?	na&tu&m re^li_nqve&s fa_ta^qve& a_bru&mpe&s tu^a& 	X_^_X_^_X_^X	1.0
Quamcumque natus sepelit haec uixit diu.	qva&mcu_mqve^ na_tu&s se^pe^li^t h[ae]c vi&xi&t di^u& 	X_^_X^^^_X_^X	1.0
Virum sequeris. Praegredi castae solent.	vi&ru&m se^qve_ri&s pr[ae]gre^di_ ca&st[ae] so^le&nt 	X_^_X_^_X_^X	0.33
Si te ipsa damnas, scelere te misera arguis.	si& te& i_psa^ da_mna&s sce^le^re^ te_ mi^se^ra& a_rgu^i&s	X_^_X^^^_^^_^X	v
Nemo nocens sibi ipse poenas inrogat.	ne&mo_ no^ce&ns si&bi& i_pse^ p[oe]na&s i_nro^ga&t 	X_^_X_^_X_^X	0.5
Multis remissa est uita quorum error nocens,	mu&lti&s re^mi_ssa& e&st vi_ta^ qvo_ru&m e&rro&r no^ce&ns 	X_^_X_^_X_^X	1.0
Non dextra fuerat. fata quis damnat sua?	no&n de_xtra^ fu^e^ra&t fa_ta^ qvi&s da&mna&t su^a& 	X_^^^X_^_X_^X	1.0
Quicumque fata iniqua sortitus fuit.	qvi&cu_mqve^ fa_ta& i&ni_qva^ so_rti&tu&s fu^i&t 	X_^_X_^_X_^X	1.0
Hic ipse Megaram nempe confixam suis	hi&c i_pse^ me^ga^ra&m ne_mpe^ co_nfi&xa&m su^i&s 	X_^^^X_^_X_^X	1.0
Strauit sagittis atque natorum indolem	str[au]i&t sa^gi_tti&s a_tqve^ na_to&ru&m i_ndo^le&m 	X_^_X_^_X_^X	0.99
Lernaea figens tela furibunda manu;	le&rn[ae]a^ fi_ge&ns te_la^ fu^ri^bu&nda_ ma^nu& 	X_^_X_^^^X_^X	1.0
Ter parricida factus ignouit tamen	te&r pa_rri^ci_da& fa_ctu^s i_gno&vi&t ta^me&n 	X_^_X_^_X_^X	1.0
Sibi, nam furoris fonte Cinyphio scelus	si^bi^ na&m fu^ro_ri&s fo_nte^ ci_ny^phi^o& sce^lu&s 	^^_^_X_^_^^_^X	0.81
Sub axe Libyco tersit et dextram abluit.	su&b a_xe^ li^by^co& te_rsi^t e&t de&xtra&m a_blu^i&t 	X_^^^X_^_X_^X	1.0
Quo, misera, pergis? cur tuas damnas manus?	qvo& mi^se^ra^ pe_rgi&s cu&r tu^a&s da&mna&s ma^nu&s 	X^^^_X_^_X_^X	1.0
Damnat meas deuictus Alcides manus:	da&mna&t me^a&s d[eu]i_ctu^s a_lci&de&s ma^nu&s 	X_^_X_^_X_^X	1.0
Placet scelus punire. Si noui Herculem,	pla&ce&t sce^lu&s pu&ni_re^ si_ no&vi& he_rcu^le&m 	X_^_X_^_X_^X	1.0
Aderit cruenti forsitan uictor mali	a^de^ri&t cru^e_nti& fo_rsi^ta&n vi&cto&r ma^li& 	^^_^_X_^_X_^X	0.82
Dolorque fractus cedet Alcidae tuo.	do&lo_rqve^ fra_ctu&s ce_de^t a_lci&d[ae] tu^o& 	X_^_X_^_X_^X	1.0
Exedit artus uirus, ut fama est, hydrae;	e_xe_di^t a_rtu_s ui_ru^s, u&t fa_ma& e&st, hy^dr[ae]; 	X_^_X_^_X_^X	m
Immensa pestis coniugis membra abstulit.	i&mme_nsa^ pe_sti&s co_nju^gi&s me&mbra& a_bstu^li&t 	X_^_X_^_X_^X	1.0
Serpentis illi uirus enectae autumas	se&rpe_nti^s i_lli& vi_ru^s e_ne&ctae& [au]tu^ma&s 	X_^_X_^_X_^X	1.0
Haut posse uinci, qui malum uiuum tulit?	h[au]t po_sse^ vi_nci& qvi_ ma^lu&m vi&vu&m tu^li&t 	X_^_X_^_X_^X	0.72
Elisit hydram, dente cum fixo stetit	e&li_si^t hy_dra&m de_nte^ cu&m fi&xo& ste^ti&t 	X_^_X_^_X_^X	1.0
Media palude uictor effuso obrutus	me^di^a_ pa^lu_de& vi_cto^r e_ffu&so& o_bru^tu&s	^^_^_X_^_X_^X	m
Artus ueneno. sanguis hunc Nessi opprimet,	a&rtu&s ve^ne_no& sa_ngvi^s hu&nc ne&ssi& o_ppri^me&t 	X_^_X_^_X_^X	0.76
Qui uicit ipsas horridi Nessi manus?	qvi& vi_ci^t i_psa&s ho_rri^di_ ne&ssi_ ma^nu&s 	X_^_X_^_X_^X	1.0
Frustra tenetur ille qui statuit mori:	fru&stra_ te^ne_tu&r i_lle^ qvi& sta^tu^i&t mo^ri& 	X_^_X_^_^^_^X	1.0
Proinde lucem fugere decretum est mihi.	pro^i_nde^ lu_ce&m fu^ge^re^ de_cre_tu&m e&st mi^hi&. 	X_^_X^^^_X_^X	m
Vixit satis quicumque cum Alcide occidit.	vi&xi&t sa^ti&s qvi&cu_mqve^ cu&m a_lci&de& o_cci^di&t 	X_^_X_^_X_^X	1.0
Per has aniles ecce te supplex comas	pe&r ha_s a^ni_le&s e_cce^ te_ su&pple&x co^ma&s 	X_^_X_^_X_^X	1.0
Atque ubera ista paene materna obsecro:	a&tqve& u_be^ra& i_sta& p[ae]ne^ ma_te&rna& o_bse^cro& 	X_^_X_^_X_^X	1.0
Depone tumidas pectoris laesi minas	de&po_ne^ tu^mi^da&s pe_cto^ri&s l[ae]si_ mi^na&s 	X_^^^X_^_X_^X	1.0
Mortisque dirae expelle decretum horridum.	mo&rti_sqve^ di_r[ae] e&xpe_lle^ de_cre&tu&m ho_rri^du&m 	X_^_X_^_X_^X	1.0
Quicumque misero forte dissuadet mori,	qvi&cu_mqve^ mi^se^ro& fo_rte^ di_ssva&de&t mo^ri& 	X_^^^X_^_X_^X	1.0
Crudelis ille est: interim poena est mori,	cru&de_li^s i_lle& e&st i_nte^ri_m p[oe]na& e&st mo^ri& 	X_^_X_^_X_^X	0.93
Sed saepe donum; pluribus uenia obfuit.	se&d s[ae]pe^ do_nu&m plu_ri^bu&s ve^ni^a& o_bfu^i&t	X_^_X_^_^^_^X	m
Defende saltem dexteram, infelix, tuam	de&fe_nde^ sa_lte&m de_xte^ra&m i_nfe&li&x tu^a&m 	X_^_X_^_X_^X	1.0
Fraudisque facinus esse, non nuptae, sciat.	fr[au]di_sqve^ fa^ci^nu&s e_sse^ no&n nu&pt[ae] sci^a&t 	X_^^^X_^_X_^X	1.0
Defendar illic: inferi absoluent ream,	de&fe_nda^r i_lli&c i_nfe^ri& a_bso&lve&nt re^a&m 	X_^_X_^_X_^X	1.0
A me ipsa damnor; purget has Pluton manus.	a& me& i_psa^ da_mno&r pu_rge^t ha&s plu&to&n ma^nu&s 	X_^_X_^_X_^X	1.0
Stabo ante ripas, immemor Lethe, tuas	sta&bo& a_nte^ ri_pa&s i_mme^mo&r le&the_ tu^a&s 	X_^_X_^_X_^X	1.0
Et umbra tristis coniugem excipiam meum.	e&t u_mbra^ tri_sti&s co_nju^ge&m e_xci^pi^a&m me^u&m 	X_^_X_^_^^_^X	1.0
Sed tu, nigrantis regna qui torques poli,	se&d tu_, ni^gra_nti&s re_gna^ qui_ to&rque&s po^li&, 	X_^_X_^_X_^X	m
Para laborem (scelera quae quisque ausus est,	pa&ra_ la^bo_re&m sce^le^ra^ qv[ae] qvi&sqve& [au]su^s e&st 	X_^_X^^^_X_^X	1.0
Hic uincit error: Iuno non ausa Herculem est	hi&c vi_nci^t e_rro&r ju_no^ no_n [au]sa& he_rcu^le&m e&st 	X_^_X_^_X_^X	0.47
Eripere terris) horridam poenam para.	e&ri^pe^re^ te_rri&s ho_rri^da&m p[oe]na&m pa^ra& 	X^^^_X_^_X_^X	1.0
Sisyphia ceruix cesset et nostros lapis	si&sy^phi^a^ ce_rvi&x ce_sse^t e&t no&stro&s la^pi&s	X^^^_X_^_X_^X	m
Impellat umeros; me uagus fugiat latex	i&mpe_lla^t u^me^ro&s me_ va^gu&s fu^gi^a&t la^te&x	X_^^^X_^_^^_^X	m
Meamque fallax unda deludat sitim;	me&a_mqve^ fa_lla&x u_nda^ de_lu&da&t si^ti&m 	X_^_X_^_X_^X	1.0
Merui manus praebere turbinibus tuis,	me^ru^i_ ma^nu&s pr[ae]be_re^ tu_rbi^ni^bu&s tu^i&s 	^^_^_X_^_^^_^X	1.0
Quaecumque regem Thessalum torques rota;	qv[ae]cu_mqve^ re_ge&m the_ssa^lu_m to&rqve&s ro^ta& 	X_^_X_^_X_^X	1.0
Effodiat auidus hinc et hinc uultur fibras;	e_ffo^di^a^t a^vi^du&s hi&nc e^t hi&nc vu_ltu&r fi^bra&s; 	X^^^^^X_^_X_^X	m
Vacat una Danais: has ego explebo uices.	va^ca^t u_na^ da^na^i&s ha_s e^go& e_xple&bo_ vi^ce&s 	^^_^^^X_^_X_^X	1.0
Laxate, manes; recipe me comitem tibi,	la&xa_te^ ma_ne&s re^ci^pe^ me_ co^mi^te&m ti^bi& 	X_^_X^^^_^^_^X	1.0
Phasiaca coniunx: peior haec, peior tuo	pha&si^a^ca^ co_nju&nx p[ei]o^r h[ae]c p[ei]o&r tu^o&	X^^^_X_^_X_^X	m
Vtroque dextra est scelere, seu mater nocens	u&tro_qve^ de_xtra& e&st sce^le^re^ s[eu] ma&te&r no^ce&ns 	X_^_X^^^_X_^X	1.0
Seu dira soror es; adde me comitem tuis,	s[eu] di_ra^ so^ro^r e&s a_dde^ me_ co^mi^te&m tu^i&s 	X_^^^X_^_^^_^X	1.0
Threicia coniunx, sceleribus; natam tuam,	thre&i^ci^a^ co_nju&nx sce^le^ri^bu_s na&ta&m tu^a&m 	X^^^_X^^^_X_^X	1.0
Althaea mater, recipe, nunc ueram tui	a&lth[ae]a^ ma_te&r re^ci^pe^ nu&nc ve&ra&m tu^i& 	X_^_X^^^_X_^X	1.0
Agnosce prolem - quid tamen tantum manus	a&gno_sce^ pro_le&m qvi&d ta^me&n ta&ntu&m ma^nu&s 	X_^_X_^_X_^X	1.0
Vestrae abstulerunt? claudite Elysium mihi,	ve_strae& a_bstu^le_ru&nt? cl[au]di^te& e_ly^si^u&m mi^hi&,	X_^_X_^_^^_^X	m
Quaecumque fidae coniuges nemoris sacri	qv[ae]cu_mqve^ fi_d[ae] co_nju^ge&s ne^mo^ri&s sa^cri& 	X_^_X_^_^^_^X	0.11
Lucos tenetis; si qua respersit manus	lu&co&s te^ne_ti&s si& qva^ re_spe&rsi&t ma^nu&s 	X_^_X_^_X_^X	1.0
Viri cruore nec memor castae facis	vi&ri& cru^o_re& ne&c me^mo&r ca&st[ae] fa^ci&s 	X_^_X_^_X_^X	1.0
Stricto cruenta Belias ferro stetit,	stri&cto& cru^e_nta& be_li^a_s fe&rro& ste^ti&t 	X_^_X_^_X_^X	1.0
In me suas agnoscat et laudet manus:	i&n me& su^a_s a&gno_sca^t e&t l[au]de&t ma^nu&s 	X_^_X_^_X_^X	1.0
In hanc abire coniugum turbam libet -	i&n ha&nc a^bi_re& co_nju^gu&m tu&rba&m li^be&t 	X_^_X_^_X_^X	1.0
Sed et illa fugiet turba tam diras manus.	se^d e^t i_lla^ fu^gi^e&t tu_rba^ ta&m di&ra&s ma^nu&s 	^^_^^^X_^_X_^X	1.0
Inuicte coniunx, innocens animus mihi,	i&nvi_cte^ co_nju&nx i_nno^ce_ns a^ni^mu&s mi^hi& 	X_^_X_^_^^_^X	1.0
Scelesta manus est. pro nimis mens credula,	sce&le_sta^ ma^nu^s e&st pro_ ni^mi&s me&ns cre_du^la& 	X_^^^X_^_X_^X	0.47
Pro Nesse fallax atque semiferi doli!	pro& ne_sse^ fa_lla&x a_tqve^ se_mi^fe^ri_ do^li& 	X_^_X_^_^^_^X	0.99
Auferre cupiens paelici eripui mihi.	[au]fe_rre^ cu^pi^e&ns p[ae]li^ci& e_ri^pu^i_ mi^hi& 	X_^^^X_^_^^_^X	1.0
Recede, Titan, tuque quae blanda tenes	re&ce_de^ ti_ta&n tu_qve^ qv[ae] bla&nda_ te^ne&s 	X_^_X_^_X_^X	1.0
In luce miseros uita: cariturae Hercule	i&n lu_ce^ mi^se^ro&s vi_ta^ ca^ri^tu&rae& he_rcu^le& 	X_^^^X_^^^X_^X	1.0
Lux uilis ista est. exigat poenas sibi	lu&x vi_li^s i_sta& e&st e_xi^ga&t p[oe]na&s si^bi& 	X_^_X_^_X_^X	1.0
Reddamque uitam - fata an extendo mea	re&dda_mqve^ vi_ta&m fa_ta& a^n e_xte&ndo_ me^a& 	X_^_X_^_X_^X	1.0
Mortemque, coniunx, ad tuas seruo manus?	mo_rte_mque^, co_niu&nx, a&d tu^a&s se_ruo_ ma^nu&s? 	X_^_X_^_X_^X	m
Virtusne superest aliqua et armatae manus	vi&rtu_sne^ su^pe^re&st a^li^qva& e^t a_rma&t[ae] ma^nu&s 	X_^^^X^^^_X_^X	1.0
Intendere arcum tela missurum ualent?	i&nte_nde^re& a_rcu&m te_la^ mi_ssu&ru&m va^le&nt 	X_^_X_^_X_^X	0.83
An arma cessant teque languenti manu	a&n a_rma^ ce_ssa&nt te_qve^ la_ngve&nti_ ma^nu& 	X_^_X_^_X_^X	1.0
Non audit arcus? si potes letum dare,	no&n [au]di^t a_rcu&s si_ po^te&s le&tu&m da^re& 	X_^_X_^_X_^X	1.0
Animosa coniunx dexteram expecto tuam.	a^ni^mo_sa^ co_nju&nx de_xte^ra&m e_xpe&cto_ tu^a&m 	^^_^_X_^_X_^X	1.0
Mors differatur: frange ut insontem Lichan,	mo&rs di_ffe^ra_tu&r: fra_nge& u^t i_nso_nte&m li^cha&n, 	X_^_X_^_X_^X	v
Alias in urbes sparge et ignotum tibi	a^li^a_s i^n u_rbe&s spa_rge& e^t i_gno&tu&m ti^bi& 	^^_^_X_^_X_^X	1.0
Inmitte in orbem; perde ut Arcadiae nefas	i&nmi_tte& i^n o_rbe&m pe_rde& u^t a_rca^di^[ae] ne^fa&s 	X_^_X_^_^^_^X	1.0
Et quidquid aliud cessit - at ab illis tamen,	e&t qvi_dqvi^d a^li^u&d ce_ssi^t a^t a^b i&lli&s ta^me&n 	X_^^^X_^^^X_^X	1.0
Coniunx, redisti. Parce iam, mater, precor,	co&nju&nx re^di_sti& pa_rce^ ja&m ma&te&r pre^co&r 	X_^_X_^_X_^X	0.97
Ignosce fatis; error a culpa uacat.	i&gno_sce^ fa_ti&s e_rro^r a_ cu&lpa_ va^ca&t 	X_^_X_^_X_^X	1.0
Si uera pietas, Hylle, quaerenda est tibi,	si& ve_ra^ pi^e^ta&s hy_lle^ qv[ae]re&nda& e&st ti^bi& 	X_^^^X_^_X_^X	1.0
Iam perime matrem - pauida quid tremuit manus?	ja&m pe^ri^me^ ma_tre&m pa^vi^da^ qvi&d tre^mu^i&t ma^nu&s 	X^^^_X^^^_^^_^X	1.0
Quid ora flectis? haec erit pietas scelus.	qvi&d o_ra^ fle_cti&s h[ae]c e^ri&t pi^e^ta&s sce^lu&s 	X_^_X_^_^^_^X	1.0
Ignaue dubitas? Herculem eripui tibi:	i&gn[au]e^ du^bi^ta&s he_rcu^le&m e_ri^pu^i_ ti^bi& 	X_^^^X_^_^^_^X	1.0
Haec, haec peremit dextra, cui debes patri	h[ae]c h[ae]c pe^re_mi&t de_xtra^ cu_j de&be&s pa^tri& 	X_^_X_^_X_^X	0.54
Auum Tonantem. maius eripui decus,	a&vu&m to^na_nte&m ma_ju^s e_ri^pu^i_ de^cu&s 	X_^_X_^_^^_^X	1.0
Quam luce tribui. si tibi ignotum est nefas,	qva&m lu_ce^ tri_b[ui] si_ ti^bi& i_gno&tu&m e&st ne^fa&s 	X_^_X_^_X_^X	1.0
A matre disce. seu tibi iugulo placet	a& ma_tre^ di_sce& s[eu] ti^bi^ ju^gu&lo& pla^ce&t	X_^_X_^^^X_^X	m
Mersisse ferrum siue maternum libet	me&rsi_sse^ fe_rru&m si_ve^ ma_te&rnu&m li^be&t 	X_^_X_^_X_^X	1.0
Inuadere uterum, mater intrepidum tibi	i&nva_de^re& u^te^ru&m ma_te^r i_ntre^pi^du&m ti^bi& 	X_^^^X_^_^^_^X	1.0
Praebebit animum. non erit tantum scelus	pr[ae]be_bi^t a^ni^mu&m no_n e^ri&t ta&ntu&m sce^lu&s 	X_^^^X_^_X_^X	1.0
A te peractum: dextera sternar tua,	a& te_ pe^ra_ctu&m de_xte^ra& ste&rna&r tu^a& 	X_^_X_^_X_^X	1.0
Sed mente nostra. natus Alcidae times?	se&d me_nte^ no_stra& na_tu^s a_lci&d[ae] ti^me&s 	X_^_X_^_X_^X	1.0
Ita nulla peragas iussa, nec frangens mala	i^ta^ nu_lla^ pe^ra^ga&s ju_ssa^ ne&c fra&nge&ns ma^la& 	^^_^^^X_^_X_^X	0.94
Erres per orbem, si qua nascetur fera	e&rre&s pe^r o_rbe&m si& qva^ na_sce&tu&r fe^ra& 	X_^_X_^_X_^X	1.0
Referas parentem: dexteram intrepidam para.	re^fe^ra&s pa^re_nte&m de_xte^ra&m i_ntre^pi^da&m pa^ra& 	^^_^_X_^_^^_^X	1.0
Patet ecce plenum pectus aerumnis: feri. -	pa^te^t e_cce^ ple_nu&m pe_ctu^s [ae]ru&mni_s fe^ri& 	^^_^_X_^_X_^X	1.0
Scelus remitto, dexterae parcent tuae	sce&lu&s re^mi_tto& de_xte^rae_ pa&rce&nt tu^[ae] 	X_^_X_^_X_^X	1.0
Eumenides ipsae: uerberum crepuit sonus.	[eu]me^ni^de^s i_ps[ae] ve_rbe^ru_m cre^pu^i&t so^nu&s 	X^^^_X_^_^^_^X	1.0
Quaenam ista torquens angue uibrato comam	qv[ae]na&m i_sta^ to_rqve&ns a_ngve^ vi_bra&to_ co^ma&m 	X_^_X_^_X_^X	1.0
Temporibus atras squalidis pinnas quatit?	te&mpo^ri^bu^s a_tra&s sqva_li^di&s pi&nna&s qva^ti&t 	X^^^_X_^_X_^X	1.0
Quid me flagranti, dira, persequeris face,	qui&d me& fla^gra_nti_, di_ra^, pe_rse^que^ri&s fa^ce&, 	X_^_X_^_^^_^X	m
Megaera? poenas poscis Alcidae? dabo.	me&g[ae]ra^ p[oe]na&s po_sci^s a_lci&d[ae] da^bo& 	X_^_X_^_X_^X	1.0
Iamne inferorum, diua, sedere arbitri?	ja&mne& i_nfe^ro_ru&m di_va^ se_de&re& a_rbi^tri& 	X_^_X_^_X_^X	0.81
Sed ecce laxas carceris uideo fores.	se&d e_cce^ la_xa&s ca_rce^ri&s vi^de^o_ fo^re&s	X_^_X_^_^^_^X	m
Quis iste saxum immane detritis gerit	qvi&s i_ste^ sa_xu&m i&mma_ne^ de_tri&ti&s ge^ri&t 	X_^_X_^_X_^X	1.0
Iam senior umeris? ecce iam uictus lapis	ja&m se^ni^o^r u^me^ri&s e_cce^ ja&m vi&ctu&s la^pi&s 	X^^^^^X_^_X_^X	1.0
Quaerit relabi. membra quis praebet rotae?	qv[ae]ri&t re^la_bi& me_mbra^ qvi&s pr[ae]be&t ro^t[ae] 	X_^_X_^_X_^X	1.0
Hic ecce pallens dira Tisiphone stetit,	hi&c e_cce^ pa_lle&ns di_ra^ ti_si^pho^ne& ste^ti&t 	X_^_X_^_^^_^X	1.0
Causam reposcit; parce uerberibus, precor,	c[au]sa&m re^po_sci&t pa_rce^ ve_rbe^ri^bu&s pre^co&r 	X_^_X_^_^^_^X	0.97
Megaera, parce, sustine Stygias faces:	me&g[ae]ra^ pa_rce& su_sti^ne& sty^gi^a&s fa^ce&s 	X_^_X_^_^^_^X	0.98
Scelus est amoris. Sed quid hoc? tellus labat	sce^lu^s e&st a^mo_ri&s se&d qvi^d ho&c te&llu&s la^ba&t 	^^_^_X_^_X_^X	1.0
Et aula tectis crepuit excussis - minax	e&t [au]la^ te_cti&s cre^pu^i^t e_xcu&ssi&s mi^na&x 	X_^_X^^^_X_^X	1.0
Vnde iste coetus? totus in uultus meos	u&nde& i_ste^ c[oe]tu&s to_tu^s i&n vu&ltu&s me^o&s 	X_^_X_^_X_^X	1.0
Decurrit orbis, hinc et hinc populi fremunt	de&cu_rri^t o_rbi&s hi&nc e^t hi&nc po^pu^li& fre^mu&nt 	X_^_X_^_^^_^X	1.0
Totusque poscit uindicem mundus suum.	to&tu_sqve^ po_sci&t vi_ndi^ce&m mu&ndu&s su^u&m 	X_^_X_^_X_^X	1.0
Iam parcite, urbes. quo fugam praeceps agam?	ja&m pa_rci^te& u_rbe&s qvo_ fu^ga&m pr[ae]ce&ps a^ga&m 	X_^_X_^_X_^X	1.0
Mors sola portus dabitur aerumnis meis.	mo&rs so_la^ po_rtu&s da^bi^tu^r [ae]ru&mni_s me^i&s 	X_^_X^^^_X_^X	0.97
Testor nitentis flammeam Phoebi rotam	te&sto&r ni^te_nti&s fla_mme^a_m ph[oe]bi_ ro^ta&m 	X_^_X_^_X_^X	0.75
Superosque testor: Herculem in terris adhuc	su^pe^ro_sqve^ te_sto&r he_rcu^le&m i&n te&rri_s a^dhu&c 	^^_^_X_^_X_^X	1.0
Moritura linquo. Fugit attonita, ei mihi.	mo^ri^tu_ra^ li_nqvo& fu_gi^t a_tto^ni^ta& [ei] mi^hi& 	^^_^_X_^_^^_^X	0.24
Peracta iam pars matris est: statuit mori;	pe&ra_cta^ ja&m pa&rs ma_tri^s e&st sta^tu^i&t mo^ri& 	X_^_X_^_^^_^X	1.0
Nunc nostra superest, mortis auferre impetum.	nu&nc no_stra^ su^pe^re&st mo_rti^s [au]fe&rre& i_mpe^tu&m 	X_^^^X_^_X_^X	0.98
O misera pietas: si mori matrem uetas,	o& mi^se^ra^ pi^e^ta&s si_ mo^ri_ ma&tre&m ve^ta&s 	X^^^^^X_^_X_^X	1.0
Patri es scelestus; si mori pateris, tamen	pa&tri& e&s sce^le_stu&s si_ mo^ri_ pa^te^ri&s ta^me&n 	X_^_X_^_^^_^X	1.0
In matre peccas - urget hinc illinc scelus.	i&n ma_tre^ pe_cca&s u_rge^t hi&nc i&lli&nc sce^lu&s 	X_^_X_^_X_^X	1.0
Inhibenda tamen est: pergam et eripiam neci.	i^nhi^be_nda^ ta^me^n e&st pe_rga&m e^t e_ri^pi^a&m ne^ci& 	^^_^^^X_^_^^_^X	1.0
Conuerte, Titan clare, anhelantes equos,	co&nve_rte^ ti_ta&n cla_re& a^nhe_la&nte_s e^qvo&s 	X_^_X_^_X_^X	1.0
Emitte noctem: pereat hic mundo dies	e&mi_tte^ no_cte&m pe^re^a^t hi&c mu&ndo_ di^e&s 	X_^_X^^^_X_^X	1.0
Quo morior, atra nube inhorrescat polus;	qvo& mo^ri^o^r a_tra& nu_be& i^nho_rre&sca&t po^lu&s 	X^^^_X_^_X_^X	1.0
Obsta nouercae. nunc, pater, caecum chaos	o&bsta_ no^ve_rc[ae] nu&nc pa^te&r c[ae]cu&m cha^o&s 	X_^_X_^_X_^X	1.0
Reddi decebat, hinc et hinc compagibus	re&ddi_ de^ce_ba&t hi&nc e^t hi&nc co&mpa_gi^bu&s 	X_^_X_^_X_^X	1.0
Ruptis uterque debuit frangi polus;	ru&pti_s u^te_rqve& de_bu^i&t fra&ngi_ po^lu&s 	X_^_X_^_X_^X	1.0
Quid parcis astris? Herculem amittis, pater.	qvi&d pa_rci^s a_stri&s he_rcu^le&m a_mi&tti&s pa^te&r 	X_^_X_^_X_^X	1.0
Nunc partem in omnem, Iuppiter, specta poli,	nu&nc pa_rte&m i^n o_mne&m ju_ppi^te&r spe&cta_ po^li& 	X_^_X_^_X_^X	1.0
Ne quis Gyges Thessalica iaculetur iuga	ne& qvi&s gy^ge_s the&ssa^li^ca^ ja^cu^le&tu&r ju^ga& 	X_^_X^^^^^X_^X	1.0
Et fiat Othrys pondus Encelado leue.	e&t fi_a^t o_thry&s po_ndu^s e_nce^la^do_ le^ve& 	X_^_X_^_^^_^X	0.92
Laxabit atri carceris iam iam fores	la&xa_bi^t a_tri& ca_rce^ri&s ja&m ja&m fo^re&s 	X_^_X_^_X_^X	1.0
Pluton superbus, uincula excutiet patri	plu&to&n su^pe_rbu&s vi_ncu^la& e_xcu^ti^e&t pa^tri& 	X_^_X_^_^^_^X	0.54
Caelumque reddet. ille qui pro fulmine	c[ae]lu_mqve^ re_dde&t i_lle^ qvi& pro& fu_lmi^ne& 	X_^_X_^_X_^X	1.0
Tuisque facibus natus in terris eram,	tu&i_sqve^ fa^ci^bu&s na_tu^s i&n te&rri_s e^ra&m 	X_^^^X_^_X_^X	1.0
Ad Styga reuertor: surget Enceladus ferox	a&d sty^ga^ re^ve_rto&r su_rge^t e_nce^la^du&s fe^ro&x 	X^^^_X_^_^^_^X	1.0
Mittetque quo nunc premitur in superos onus.	mi&tte_tqve^ qvo_ nu&nc pre^mi^tu^r i&n su^pe^ro_s o^nu&s 	X_^_X^^^_^^_^X	1.0
Regnum omne, genitor, aetheris dubium tibi	re&gnu&m o_mne^ ge^ni^to&r [ae]the^ri&s du^bi^u&m ti^bi& 	X_^^^X_^_^^_^X	1.0
Mors nostra faciet - antequam spolium tui	mo&rs no_stra^ fa^ci^e&t a_nte^qva_m spo^li^u&m tu^i& 	X_^^^X_^_^^_^X	1.0
Caelum omne fiat, conde me tota, pater,	c[ae]lu&m o_mne^ fi_a&t co_nde^ me_ to&ta_ pa^te&r 	X_^_X_^_X_^X	1.0
Mundi ruina, frange quem perdis polum.	mu&ndi_ ru^i_na& fra_nge^ qve&m pe&rdi&s po^lu&m 	X_^_X_^_X_^X	1.0
Ego qui relicta morte, contempta Styge,	e^go^ qvi_ re^li_cta& mo_rte^ co_nte&mpta& sty^ge& 	^^_^_X_^_X_^X	1.0
Per media Lethes stagna cum spolio redi	pe&r me^di^a^ le_the&s sta_gna^ cu&m spo^li^o_ re^di& 	X^^^_X_^_^^_^X	1.0
Quo paene lapsis excidit Titan equis,	qvo& p[ae]ne^ la_psi&s e_xci^di&t ti&ta_n e^qvi&s 	X_^_X_^_X_^X	1.0
Ego quem deorum regna senserunt tria,	e^go^ qve&m de^o_ru&m re_gna^ se_nse&ru&nt tri^a& 	^^_^_X_^_X_^X	1.0
Morior nec ullus per meum stridet latus	mo^ri^o&r ne^c u_llu&s pe&r me^u&m stri&de&t la^tu&s 	^^_^_X_^_X_^X	0.98
Transmissus ensis, haut meae telum necis	tra&nsmi_ssu^s e_nsi&s h[au]t me^[ae] te&lu&m ne^ci&s 	X_^_X_^_X_^X	1.0
Saxum est nec instar montis abrupti lapis	sa&xu&m e&st ne^c i_nsta&r mo_nti^s a_bru&pti_ la^pi&s 	X_^_X_^_X_^X	0.79
Aut totus Othrys, non truci rictu gigas	[au]t to_tu^s o_thry&s no&n tru^ci_ ri&ctu_ gi^ga&s 	X_^_X_^_X_^X	1.0
Pindo cadauer obruit toto meum:	pi&ndo_ ca^d[au]e&r o_bru^i&t to&to_ me^u&m 	X_^_X_^_X_^X	1.0
Sine hoste uincor, quodque me torquet magis	si&ne& ho_ste^ vi_nco&r qvo_dqve^ me_ to&rqve&t ma^gi&s 	X_^_X_^_X_^X	1.0
(O misera virtus) summus Alcidae dies	o& mi^se^ra^ vi_rtu&s su_mmu^s a_lci&d[ae] di^e&s 	X^^^_X_^_X_^X	1.0
Nullum malum prosternit; inpendo, ei mihi,	nu&llu&m ma^lu&m pro&ste_rni^t i_npe&ndo& [ei] mi^hi& 	X_^_X_^_X_^X	0.72
In nulla uitam facta. pro mundi arbiter	i&n nu_lla^ vi_ta&m fa_cta^ pro_ mu&ndi& a_rbi^te&r 	X_^_X_^_X_^X	1.0
Superique quondam dexterae testes meae,	su^pe^ri_qve^ qvo_nda&m de_xte^rae_ te&ste&s me^[ae] 	^^_^_X_^_X_^X	1.0
Pro cuncta tellus, Herculis uestri placet	pro& cu_ncta^ te_llu&s he_rcu^li&s ve&stri& pla^ce&t 	X_^_X_^_X_^X	0.97
Mortem perire? dirus o nobis pudor,	mo&rte&m pe^ri_re& di_ru^s o_ no&bi&s pu^do&r 	X_^_X_^_X_^X	1.0
O turpe fatum: femina Herculeae necis	o& tu_rpe^ fa_tu&m fe_mi^na& he_rcu^le^[ae] ne^ci&s 	X_^_X_^_^^_^X	1.0
Auctor feretur! morior Alcides quibus!	[au]cto&r fe^re_tu&r mo^ri^o^r a_lci&de&s qvi^bu&s 	X_^_X^^^_X_^X	1.0
Inuicta si me cadere feminea manu	i&nvi_cta^ si_ me& ca^de^re^ fe_mi^ne^a_ ma^nu&	X_^_X^^^_^^_^X	m
Voluere fata perque tam turpes colus	vo&lue_re^ fa_ta& pe_rque^ ta&m tu&rpe&s co^lu&s	X_^_X_^_X_^X	m
Mea mors cucurrit, cadere placuisset mihi	me^a^ mo&rs cu^cu_rri&t ca^de^re^ pla^cu^i&sse&t mi^hi& 	^^_^_X^^^^^X_^X	1.0
Iunonis odio: feminae caderem manu,	ju&no_ni^s o^di^o& fe_mi^nae_ ca^de^re&m ma^nu& 	X_^^^X_^_^^_^X	1.0
Sed caelum habentis. si nimis superis fuit,	se&d c[ae]lu&m ha^be_nti&s si_ ni^mi&s su^pe^ri&s fu^i&t 	X_^_X_^_^^_^X	1.0
Scythico sub axe genita domuisset meas	scy^thi^co_ su^b a_xe& ge^ni^ta^ do^mu^i&sse&t me^a&s 	^^_^_X^^^^^X_^X	1.0
Vires Amazon - feminae cuius manu	vi&re_s a^ma_zo&n fe_mi^nae_ cu&ju&s ma^nu& 	X_^_X_^_X_^X	1.0
Iunonis hostis uincor! hinc grauior tui,	ju&no_ni^s ho_sti&s vi_nco^r hi&nc gra^vi^o&r tu^i& 	X_^_X_^_^^_^X	1.0
Nouerca, pudor est. quid diem hunc laetum uocas?	no&ve_rca^ pu^do^r e&st qvi&d di^e&m hu&nc l[ae]tu&m vo^ca&s 	X_^^^X_^_X_^X	1.0
Quid tale tellus genuit iratae tibi?	qvi&d ta_le^ te_llu&s ge^nu^i^t i_ra&tae_ ti^bi& 	X_^_X^^^_X_^X	1.0
Mortalis odia femina excessit tua.	mo&rta_li^s o^di^a& fe_mi^na& e_xce&ssi&t tu^a& 	X_^^^X_^_X_^X	1.0
Adhuc furebas esse te Alcidae imparem:	a&dhu&c fu^re_ba&s e_sse^ te& a_lci&d[ae] i_mpa^re&m 	X_^_X_^_X_^X	1.0
Victa es duobus - pudeat irarum deos.	vi&cta& e&s du^o_bu&s pu^de^a^t i_ra&ru&m de^o&s 	X_^_X^^^_X_^X	1.0
Vtinam meo cruore satiasset suos	u^ti^na&m me^o& cru&o_re^ sa^ti^a&sse&t su^o&s 	^^_^_X_^^^X_^X	1.0
Nemeaea rictus pestis aut centum anguibus	ne^me^[ae]a^ ri_ctu&s pe_sti^s [au]t ce&ntu&m a_ngvi^bu&s 	^^_^_X_^_X_^X	1.0
Vallatus hydram tabe pauissem mea,	va&lla_tu^s hy_dra&m ta_be^ p[au]i&sse&m me^a& 	X_^_X_^_X_^X	1.0
Vtinam fuissem praeda Centauris datus	u^ti^na&m fu^i_sse&m pr[ae]da^ ce_nt[au]ri_s da^tu&s 	^^_^_X_^_X_^X	1.0
Aut inter umbras uinctus aeterno miser	[au]t i_nte^r u_mbra&s vi_nctu^s [ae]te&rno_ mi^se&r 	X_^_X_^_X_^X	1.0
Saxo sederem! spolia nunc traxi ultima	sa&xo_ se^de_re&m spo^li^a^ nu&nc tra&xi& u_lti^ma& 	X_^_X^^^_X_^X	0.02
Fato stupente, nunc ab inferna Styge	fa&to& stu^pe_nte& nu&nc a^b i_nfe&rna& sty^ge& 	X_^_X_^_X_^X	1.0
Lucem recepi, Ditis euici moras -	lu&ce&m re^ce_pi& di_ti^s [eu]i&ci_ mo^ra&s 	X_^_X_^_X_^X	1.0
Vbique mors me fugit, ut titulo inclitae	u&bi_qve^ mo&rs me& fu_gi^t u&t ti^tu^lo& i_ncli^tae& 	X_^_X_^_^^_^X	0.24
Mortis carerem. pro ferae, uictae ferae!	mo&rti&s ca^re_re&m pro_ fe^r[ae] vi&ct[ae] fe^r[ae] 	X_^_X_^_X_^X	1.0
Non me triformis sole conspecto canis	no&n me& tri^fo_rmi&s so_le^ co_nspe&cto_ ca^ni&s 	X_^_X_^_X_^X	0.4
Ad Styga reuexit, non sub Hesperio polo	a&d sty^ga^ re^ve_xi&t no&n su^b he_spe^ri^o_ po^lo& 	X^^^_X_^_^^_^X	1.0
Hibera uicit turba pastoris feri,	hi&be_ra^ vi_ci&t tu_rba^ pa_sto&ri&s fe^ri& 	X_^_X_^_X_^X	1.0
Non gemina serpens - perdidi mortem, ei mihi,	no&n ge^mi^na^ se_rpe&ns pe_rdi^di_ mo&rte&m [ei] mi^hi& 	X^^^_X_^_X_^X	1.0
Totiens honestam: titulus extremus quis est!	to^ti^e&ns ho^ne_sta&m ti^tu^lu^s e_xtre&mu&s qvi^s e&st 	^^_^_X^^^_X_^X	0.76
Eheu quis intus scorpios, quis feruida	e&h[eu] qvi^s i_ntu&s sco_rpi^o&s qvi&s fe_rvi^da& 	X_^_X_^_X_^X	0.76
Plaga reuulsus cancer infixus meas	pla&ga_ re^vu_lsu&s ca_nce^r i_nfi&xu&s me^a&s 	X_^_X_^_X_^X	1.0
Vrit medullas? sanguinis quondam capax	u&ri&t me^du_lla&s sa_ngvi^ni&s qvo&nda&m ca^pa&x 	X_^_X_^_X_^X	1.0
Tumidi uigor pulmonis arentes fibras	tu^mi^di_ ui^go&r pu_lmo_ni^s a_re_nte&s fi^bra&s 	^^_^_X_^_X_^X	m
Distendit, ardet felle siccato iecur	di&ste_ndi^t a_rde&t fe_lle^ si_cca&to_ je^cu&r 	X_^_X_^_X_^X	1.0
Totumque lentus sanguinem auexit uapor.	to&tu_mqve^ le_ntu&s sa_ngvi^ne&m [au]e&xi&t va^po&r 	X_^_X_^_X_^X	1.0
Primam cutem consumpsit, hinc aditum nefas	pri&ma&m cu^te&m co&nsu_mpsi^t hi&nc a^di^tu&m ne^fa&s 	X_^_X_^_^^_^X	1.0
In membra fecit, abstulit pestis latus,	i&n me_mbra^ fe_ci&t a_bstu^li&t pe&sti&s la^tu&s 	X_^_X_^_X_^X	0.98
Exedit artus penitus et totas malum	e&xe_di^t a_rtu&s pe^ni^tu^s e&t to&ta&s ma^lu&m 	X_^_X^^^_X_^X	0.72
Hausit medullas: ossibus uacuis sedet;	h[au]si&t me^du_lla&s o_ssi^bu&s va^cu^i&s se^de&t	X_^_X_^_^^_^X	m
Nec ossa durant ipsa, sed compagibus	ne&c o_ssa^ du_ra&nt i_psa^ se&d co&mpa_gi^bu&s 	X_^_X_^_X_^X	1.0
Discussa ruptis mole conlapsa fluunt.	di&scu_ssa^ ru_pti&s mo_le^ co_nla&psa_ flu^u&nt 	X_^_X_^_X_^X	1.0
Defecit ingens corpus et pesti satis	de&fe_ci^t i_nge&ns co_rpu^s e&t pe&sti_ sa^ti&s 	X_^_X_^_X_^X	1.0
Herculea non sunt membra - pro, quantum est malum	he&rcu^le^a^ no&n su&nt me_mbra^ pro& qva&ntu&m e&st ma^lu&m 	X^^^_X_^_X_^X	0.72
Quod esse uastum fateor, o dirum nefas!	qvo&d e_sse^ va_stu&m fa^te^o^r o_ di&ru&m ne^fa&s 	X_^_X^^^_X_^X	1.0
En cernite, urbes, cernite ex illo Hercule	e&n ce_rni^te& u_rbe&s ce_rni^te& e&x i&llo& he_rcu^le& 	X_^_X_^_X_^X	1.0
Quid iam supersit. Herculem agnoscis, pater?	qvi&d ja&m su^pe_rsi&t he_rcu^le&m a_gno&sci&s pa^te&r 	X_^_X_^_X_^X	1.0
Hisne ego lacertis colla Nemeaei mali	hi&sne& e^go^ la^ce_rti&s co_lla^ ne^me^[ae]i_ ma^li& 	X^^^_X_^^^X_^X	0.82
Elisa pressi? tensus hac arcus manu	e&li_sa^ pre_ssi& te_nsu^s ha_c a&rcu&s ma^nu& 	X_^_X_^_X_^X	1.0
Astris ab ipsis detulit Stymphalidas?	a&stri_s a^b i_psi&s de_tu^li&t sty&mpha_li^da&s 	X_^_X_^_X_^X	1.0
His ego citatam gressibus uici feram	hi&s e^go^ ci^ta_ta&m gre_ssi^bu&s vi&ci_ fe^ra&m 	X^^^_X_^_X_^X	1.0
Radiante clarum fronte gestantem caput?	ra^di^a_nte^ cla_ru&m fro_nte^ ge_sta&nte&m ca^pu&t 	^^_^_X_^_X_^X	1.0
His fracta Calpe manibus emisit fretum?	hi&s fra_cta^ ca_lpe& ma^ni^bu^s e_mi&si&t fre^tu&m 	X_^_X^^^_X_^X	0.63
His tot ferae, tot scelera, tot reges iacent?	hi&s to&t fe^r[ae] to&t sce^le^ra^ to&t re&ge&s ja^ce&nt 	X_^_X^^^_X_^X	1.0
His mundus umeris sedit? haec moles mei est,	hi&s mu_ndu^s u^me^ri&s se_di^t h[ae]c mo&le&s me^i& e&st 	X_^^^X_^_X_^X	1.0
Haecne illa ceruix? has ego opposui manus	h[ae]cne& i_lla^ ce_rvi&x ha_s e^go& o_ppo^su^i_ ma^nu&s 	X_^_X_^_^^_^X	1.0
Caelo ruenti? quis mea custos manu	c[ae]lo_ ru^e_nti& qvi&s me^a_ cu&sto&s ma^nu& 	X_^_X_^_X_^X	1.0
Trahetur ultra Stygius? ubi uires prius	tra&he_tu^r u_ltra& sty^gi^u^s u^bi^ vi&re&s pri^u&s 	X_^_X^^^^^X_^X	1.0
Memet sepultae? quid patrem appello Iouem?	me&me&t se^pu_ltae& qvi&d pa^tre&m a_ppe&llo_ jo^ve&m 	X_^_X_^_X_^X	0.71
Quid per Tonantem uindico caelum mihi?	qvi&d pe&r to^na_nte&m vi_ndi^co_ c[ae]lu&m mi^hi& 	X_^_X_^_X_^X	1.0
Iam, iam meus credetur Amphitryon pater.	ja&m ja&m me^u&s cre&de_tu^r a_mphi^try^o&n pa^te&r 	X_^_X_^_^^_^X	1.0
Quaecumque pestis uiscere in nostro lates,	qv[ae]cu_mqve^ pe_sti&s vi_sce^re& i&n no&stro_ la^te&s 	X_^_X_^_X_^X	1.0
Procede - quid me uulnere occulto petis?	pro&ce_de^ qvi&d me& vu_lne^re& o_ccu&lto_ pe^ti&s 	X_^_X_^_X_^X	1.0
Quis te sub axe frigido pontus Scythes,	qvi&s te_ su^b a_xe& fri_gi^do_ po&ntu&s scy^the&s 	X_^_X_^_X_^X	1.0
Quae pigra Tethys genuit aut Maurum premens	qv[ae] pi_gra^ te_thy&s ge^nu^i^t [au]t m[au]ru&m pre^me&ns 	X_^_X^^^_X_^X	1.0
Hibera Calpe litus? o dirum malum!	hi&be_ra^ ca_lpe& li_tu^s o_ di&ru&m ma^lu&m 	X_^_X_^_X_^X	0.72
Vtrumne serpens squalidum crista caput	u&tru_mne^ se_rpe&ns sqva_li^du&m cri&sta_ ca^pu&t 	X_^_X_^_X_^X	1.0
Vibrans an aliquod et mihi ignotum malum?	vi&bra&ns a^n a^li^qvo&d e&t mi^hi& i_gno&tu&m ma^lu&m 	X_^^^X_^_X_^X	0.72
Numquid cruore es genita Lernaeae ferae	nu&mqvi&d cru^o_re& e&s ge^ni^ta^ le_rn[ae][ae] fe^r[ae] 	X_^_X^^^_X_^X	1.0
An te reliquit Stygius in terris canis?	a&n te_ re^li_qvi&t sty^gi^u^s i&n te&rri&s ca^ni&s 	X_^_X^^^_X_^X	0.4
Omne es malum nullumque - quis uoltus tibi est?	o&mne& e&s ma^lu&m nu&llu_mqve^ qvi&s vo&ltu&s ti^bi& e&st 	X_^_X_^_X_^X	0.72
Concede saltem scire quo peream malo;	co&nce_de^ sa_lte&m sci_re^ qvo_ pe^re^a&m ma^lo& 	X_^_X_^_^^_^X	0.49
Quaecumque pestis siue quaecumque es fera,	qv[ae]cu_mqve^ pe_sti&s si_ve^ qv[ae]cu&mqve& e&s fe^ra& 	X_^_X_^_X_^X	1.0
Palam timere. quis tibi in medias locum	pa&la&m ti^me_re& qvi&s ti^bi& i&n me^di^a&s lo^cu&m 	X_^_X_^_^^_^X	1.0
Fecit medullas? ecce direpta cute	fe&ci&t me^du_lla&s e_cce^ di_re&pta_ cu^te& 	X_^_X_^_X_^X	1.0
Viscera manus detexit; ulterior tamen	vi&sce^ra^ ma^nu&s de&te_xi^t u_lte^ri^o&r ta^me&n 	X^^^_X_^_^^_^X	1.0
Inuenta latebra est - o malum simile Herculi!	i&nve_nta^ la^te^bra& e&st o_ ma^lu&m si^mi^le& he_rcu^li& 	X_^^^X_^_^^_^X	0.12
Vnde iste fletus? unde in has lacrimae genas?	u&nde& i_ste^ fle_tu&s u_nde& i^n ha&s la^cri^m[ae] ge^na&s 	X_^_X_^_^^_^X	1.0
Inuictus olim uoltus et numquam malis	i&nvi_ctu^s o_li&m vo_ltu^s e&t nu&mqva&m ma^li&s 	X_^_X_^_X_^X	0.92
Lacrimas suis praebere consuetus (pudet)	la^cri^ma&s su^i&s pr[ae]be_re^ co_nsve&tu&s pu^de&t 	^^_^_X_^_X_^X	1.0
Iam flere didicit. quis dies fletum Herculis,	ja&m fle_re^ di^di^ci&t qvi&s di^e&s fle&tu&m he_rcu^li&s 	X_^^^X_^_X_^X	1.0
Quae terra uidit? siccus aerumnas tuli.	qv[ae] te_rra^ vi_di&t si_ccu^s [ae]ru&mna_s tu^li& 	X_^_X_^_X_^X	1.0
Tibi illa uirtus, quae tot elisit mala,	ti&bi& i_lla^ vi_rtu&s qv[ae] to^t e_li&si&t ma^la& 	X_^_X_^_X_^X	0.94
Tibi cessit uni; prima et ante omnis mihi	ti^bi^ ce_ssi^t u_ni& pri_ma& e^t a_nte& o&mni&s mi^hi& 	^^_^_X_^_X_^X	0.85
Fletum abstulisti: durior saxo horrido	fle&tu&m a_bstu^li_sti& du_ri^o&r sa&xo& ho_rri^do& 	X_^_X_^_X_^X	1.0
Et chalybe uoltus et uaga Symplegade	e&t cha^ly^be^ vo_ltu&s e&t va^ga_ sy&mple_ga^de& 	X^^^_X_^_X_^X	1.0
Victus minas infregit et lacrimam expulit.	vi&ctu&s mi^na_s i&nfre_gi^t e&t la^cri^ma&m e_xpu^li&t	X_^_X_^_^^_^X	m
Flentem, gementem, summe pro rector poli,	fle&nte&m ge^me_nte&m su_mme^ pro_ re&cto&r po^li& 	X_^_X_^_X_^X	1.0
Me terra uidit, quodque me torquet magis,	me& te_rra^ vi_di&t qvo_dqve^ me_ to&rqve&t ma^gi&s 	X_^_X_^_X_^X	1.0
Nouerca uidit. - urit ecce iterum fibras,	no&ue_rca^ ui_di&t. - u_ri^t e_cce& i^te^ru&m fi^bra&s, 	X_^_X_^_^^_^X	m
Incaluit ardor: unde nunc fulmen mihi?	i&nca^lu^i^t a_rdo&r u_nde^ nu&nc fu&lme&n mi^hi& 	X^^^_X_^_X_^X	1.0
Conuerte uoltus ad meas clades, pater:	co&nve_rte^ vo_ltu&s a&d me^a&s cla&de&s pa^te&r 	X_^_X_^_X_^X	1.0
Numquam ad tuas confugit Alcides manus,	nu_mqua&m a&d tu^a&s co_nfu_gi^t a_lci&de&s ma^nu&s, 	X_^_X_^_X_^X	m
Non cum per artus hydra fecundum meos	no&n cu&m pe^r a_rtu&s hy_dra^ fe_cu&ndu&m me^o&s 	X_^_X_^_X_^X	1.0
Caput explicaret; inter infernos lacus	ca^pu^t e_xpli^ca_re&t i_nte^r i_nfe&rno&s la^cu&s 	^^_^_X_^_X_^X	0.99
Possessus atra nocte cum Fato steti	po&sse_ssu^s a_tra& no_cte^ cu&m fa&to& ste^ti& 	X_^_X_^_X_^X	1.0
Nec inuocaui; tot feras uici horridas,	ne&c i_nvo^ca_vi& to&t fe^ra&s vi&ci& ho_rri^da&s 	X_^_X_^_X_^X	1.0
Reges, tyrannos, non tamen uoltus meos	re&ge&s ty^ra_nno&s no&n ta^me&n vo&ltu&s me^o&s 	X_^_X_^_X_^X	1.0
In astra torsi: semper haec nobis manus	i&n a_stra^ to_rsi& se_mpe^r h[ae]c no&bi&s ma^nu&s 	X_^_X_^_X_^X	1.0
Votum spopondit; nulla propter me sacro	vo&tu&m spo^po_ndi&t nu_lla^ pro_pte&r me_ sa^cro& 	X_^_X_^_X_^X	0.18
Micuere caelo fulmina - hic aliquid dies	mi^cu^e_re^ c[ae]lo& fu_lmi^na& hi_c a^li^qvi&d di^e&s	^^_^_X_^_^^_^X	m
Optare iussit. primus audierit preces	o&pta_re^ ju_ssi&t pri_mu^s [au]di^e^ri&t pre^ce&s 	X_^_X_^_^^_^X	0.99
Idemque summus: unicum fulmen peto;	i&de_mqve^ su_mmu&s u_ni^cu&m fu&lme&n pe^to& 	X_^_X_^_X_^X	1.0
Giganta crede (non minus caelum mihi	gi&ga_nta^ cre_de& no&n mi^nu&s c[ae]lu&m mi^hi& 	X_^_X_^_X_^X	1.0
Asserere potui - dum patrem uerum imputo,	a&sse^re^re^ po^tu^i& du&m pa^tre&m ve&ru&m i_mpu^to& 	X^^^^^X_^_X_^X	0.71
Caelo peperci) siue crudelis, pater,	c[ae]lo_ pe^pe_rci& si_ve^ cru_de&li&s pa^te&r 	X_^_X_^_X_^X	1.0
Siue es misericors, commoda nato manum	si&ve& e&s mi^se^ri^co&rs co_mmo^da_ na&to_ ma^nu&m 	X_^^^X_^_X_^X	1.0
Properante morte et occupa hanc laudem tibi.	pro^pe^ra_nte^ mo_rte& e&t o_ccu^pa& ha&nc l[au]de&m ti^bi& 	^^_^_X_^_X_^X	1.0
Vel si piget manusque detrectat nefas,	ve&l si_ pi^ge&t ma&nu_sqve^ de_tre&cta_t ne^fa&s 	X_^_X_^_X_^X	1.0
Emitte Siculo uertice ardentes, pater,	e&mi_tte^ si^cu^lo& ve_rti^ce& a_rde&nte&s pa^te&r 	X_^^^X_^_X_^X	1.0
Titanas, in me qui manu Pindum ferant	ti&ta_na^s i&n me& qvi_ ma^nu_ pi&ndu_m fe^ra&nt 	X_^_X_^_X_^X	1.0
Ossaque qui me monte proiecto opprimant.	o_ssa_que^ qui_ me_ mo_nte^ pro_ie_cto& o_ppri^ma&nt. 	X_^_X_^_X_^X	m
Abrumpat Erebi claustra, me stricto petat	a&bru_mpa^t e^re^bi& cl[au]stra^ me& stri&cto_ pe^ta&t 	X_^^^X_^_X_^X	1.0
Bellona ferro; mitte Gradiuum trucem,	be&llo_na^ fe_rro& mi_tte^ gra_di&vu&m tru^ce&m 	X_^_X_^_X_^X	1.0
Armetur in me dirus: est frater quidem,	a&rme_tu^r i&n me& di_ru^s e&st fra&te&r qvi^de&m 	X_^_X_^_X_^X	1.0
Sed ex nouerca. Tu quoque, Alcidae soror	se&d e&x no^ve_rca& tu& qvo^qve& a_lci&d[ae] so^ro&r 	X_^_X_^_X_^X	0.93
Tantum ex parente, cuspidem in fratrem tuum	ta&ntu&m e&x pa^re_nte& cu_spi^de&m i&n fra&tre&m tu^u&m 	X_^_X_^_X_^X	1.0
Iaculare, Pallas. Supplices tendo manus	ja^cu^la_re^ pa_lla&s su_ppli^ce&s te&ndo_ ma^nu&s	^^_^_X_^_X_^X	m
Ad te, nouerca: sparge tu saltem, precor,	a&d te_ no^ve_rca& spa_rge^ tu_ sa&lte&m pre^co&r 	X_^_X_^_X_^X	1.0
Telum: perire feminae possum manu.	te&lu&m pe^ri_re& fe_mi^nae_ po&ssu&m ma^nu& 	X_^_X_^_X_^X	1.0
Iam fracta, iam satiata quid pascis minas?	ja&m fra_cta^ ja&m sa^ti^a_ta^ qvi&d pa&sci&s mi^na&s 	X_^_^^_^_X_^X	1.0
Quid quaeris ultra? supplicem Alciden uides,	qvi&d qv[ae]ri^s u_ltra& su_ppli^ce&m a_lci&de&n vi^de&s 	X_^_X_^_X_^X	1.0
Et nulla tellus, nulla me uidit fera	e&t nu_lla^ te_llu&s nu_lla^ me_ vi&di&t fe^ra& 	X_^_X_^_X_^X	1.0
Te deprecantem. nunc mihi irata satis	te& de_pre^ca_nte&m nu&nc mi^hi& i_ra&ta_ sa^ti&s 	X_^_X_^_X_^X	1.0
Opus est nouerca - nunc tuus cessat dolor?	o^pu^s e&st no^ve_rca& nu&nc tu^u&s ce&ssa&t do^lo&r 	^^_^_X_^_X_^X	1.0
Nunc odia ponis? parcis ubi uotum est mori.	nu&nc o^di^a^ po_ni&s pa_rci^s u^bi^ vo&tu&m e&st mo^ri& 	X^^^_X_^^^X_^X	1.0
O terra et urbes, non facem quisquam Herculi,	o& te_rra& e^t u_rbe&s no&n fa^ce&m qvi&sqva&m he_rcu^li& 	X_^_X_^_X_^X	1.0
Non arma tradet? tela subtrahitis mihi?	no&n a_rma^ tra_de&t te_la^ su_btra^hi^ti&s mi^hi& 	X_^_X_^_^^_^X	1.0
Ita nulla saeuas terra concipiat feras	i^ta^ nu_lla^ s[ae]va&s te_rra^ co_nci^pi^a&t fe^ra&s 	^^_^_X_^_^^_^X	1.0
Post me sepultum, nec meas umquam manus	po&st me_ se^pu_ltu&m ne&c me^a_s u&mqva&m ma^nu&s 	X_^_X_^_X_^X	1.0
Imploret orbis, si qua nascentur mala	i&mplo_re^t o_rbi&s si& qva^ na_sce&ntu&r ma^la& 	X_^_X_^_X_^X	0.94
Nascatur alius: undique infelix caput	na&sca_tu^r a^li^u&s u_ndi^qve& i_nfe&li&x ca^pu&t 	X_^^^X_^_X_^X	1.0
Mactate saxis, uincite aerumnas meas.	ma&cta_te^ sa_xi&s vi_nci^te& [ae]ru&mna_s me^a&s 	X_^_X_^_X_^X	0.83
Ingrate cessas orbis? excidimus tibi?	i&ngra_te^ ce_ssa&s o_rbi^s e_xci^di^mu&s ti^bi& 	X_^_X_^_^^_^X	0.88
Adhuc malis ferisque suppositus fores,	a&dhu&c ma^li&s fe&ri_sqve^ su_ppo^si^tu&s fo^re&s 	X_^_X_^_^^_^X	0.92
Ni me tulisses. uindicem uestrum malis	ni& me_ tu^li_sse&s vi_ndi^ce&m ve&stru&m ma^li&s 	X_^_X_^_X_^X	0.92
Eripite, populi: tempus hoc uobis datur	e&ri^pi^te^ po^pu^li& te_mpu^s ho&c vo&bi&s da^tu&r 	X^^^^^X_^_X_^X	1.0
Pensare merita - mors erit pretium omnium.	pe&nsa_re^ me^ri^ta& mo&rs e^ri&t pre^ti^u&m o_mni^u&m 	X_^^^X_^_^^_^X	1.0
Quas misera terras mater Alcidae petam?	qva&s mi^se^ra^ te_rra&s ma_te^r a_lci&d[ae] pe^ta&m 	X^^^_X_^_X_^X	1.0
Vbi natus, ubinam est? certa si uisus notat,	u^bi^ na_tu^s u^bi^na&m e&st ce_rta^ si_ vi&su&s no^ta&t 	^^_^^^X_^_X_^X	1.0
Reclinis ecce corde anhelante aestuat;	re&cli_ni^s e_cce& co_rde& a^nhe_la&nte& [ae]stu^a&t 	X_^_X_^_X_^X	1.0
Gemit: peractum est. membra complecti ultima,	ge&mi&t pe^ra_ctu&m e&st me_mbra^ co_mple&cti& u_lti^ma& 	X_^_X_^_X_^X	1.0
O nate, liceat; spiritus fugiens meo	o& na_te^ li^ce^a&t spi_ri^tu&s fu^gi^e&ns me^o& 	X_^^^X_^_^^_^X	1.0
Legatur ore: bracchia, amplexus cape.	le&ga_tu^r o_re& bra_cchi^a& a_mple&xu&s ca^pe& 	X_^_X_^_X_^X	1.0
Vbi membra sunt? ubi illa quae mundum tulit	u^bi^ me_mbra^ su&nt u&bi& i_lla^ qv[ae] mu&ndu&m tu^li&t 	^^_^_X_^_X_^X	1.0
Stelligera ceruix? quis tibi exiguam tui	ste&lli^ge^ra^ ce_rvi&x qvi&s ti^bi& e_xi^gu^a&m tu^i& 	X^^^_X_^_^^_^X	1.0
Partem reliquit? Herculem spectas quidem,	pa&rte&m re^li_qvi&t he_rcu^le_m spe&cta&s qvi^de&m 	X_^_X_^_X_^X	1.0
Mater, sed umbram et uile nescioquid mei.	ma&te&r se^d u_mbra&m e&t vi_le^ ne_sci^o^qvi&d me^i& 	X_^_X_^_^^_^X	1.0
Agnosce, mater - ora quid flectis retro	a&gno_sce^ ma_te&r o_ra^ qvi&d fle&cti&s re^tro& 	X_^_X_^_X_^X	0.35
Vultumque mergis? Herculem dici tuum	vu&ltu_mqve^ me_rgi&s he_rcu^le_m di&ci_ tu^u&m 	X_^_X_^_X_^X	1.0
Partum erubescis? Quis feram mundus nouam,	pa&rtu&m e_ru^be_sci&s qvi&s fe^ra&m mu&ndu&s no^va&m 	X_^_X_^_X_^X	1.0
Quae terra genuit? quodue tam dirum nefas	qv[ae] te_rra^ ge^nu^i&t qvo_dve^ ta&m di&ru&m ne^fa&s 	X_^^^X_^_X_^X	1.0
De te triumphat? uictor Herculeus quis est?	de& te& tri^u_mpha&t vi_cto^r he_rcu^le^u&s qvi^s e&st 	X_^_X_^_^^_^X	0.76
Nuptae iacentem cernis Alciden dolis.	nu&pt[ae] ja^ce_nte&m ce_rni^s a_lci&de&n do^li&s 	X_^_X_^_X_^X	1.0
Quis tantus est qui uincat Alciden dolus?	qvi&s ta_ntu^s e&st qvi& vi_nca^t a_lci&de&n do^lu&s 	X_^_X_^_X_^X	1.0
Quicumque, mater, feminae iratae sat est.	qvi&cu_mqve^ ma_te&r fe_mi^nae& i_ra&tae_ sa^t e&st 	X_^_X_^_X_^X	1.0
Et unde in artus pestis aut ossa incidit?	e&t u_nde& i^n a_rtu&s pe_sti^s [au]t o&ssa& i_nci^di&t 	X_^_X_^_X_^X	0.96
Aditum uenenis palla femineis dedit.	a^di^tu&m ve^ne_ni&s pa_lla^ fe_mi^ne^i&s de^di&t 	^^_^_X_^_^^_^X	1.0
Vbinam ista palla est? membra nudata intuor.	u^bi^na&m i_sta^ pa_lla& e&st me_mbra^ nu_da&ta& i_ntu^o&r 	^^_^_X_^_X_^X	1.0
Consumpta mecum est. Tantane inuenta est lues?	co&nsu_mpta^ me_cu&m e&st ta_nta^ne& i_nve&nta& e&st lu^e&s 	X_^_X_^_X_^X	1.0
Errare mediis crede uisceribus meis,	e&rra_re^ me^di^i&s cre_de^ vi_sce^ri^bu&s me^i&s 	X_^^^X_^_^^_^X	1.0
O mater, hydram et mille cum Lerna feras.	o& ma_te^r hy_dra&m e&t mi_lle^ cu&m le&rna_ fe^ra&s 	X_^_X_^_X_^X	1.0
Quae tanta nubes flamma Sicanias secans,	qv[ae] ta_nta^ nu_be&s fla_mma^ si_ca^ni^a&s se^ca&ns 	X_^_X_^_^^_^X	1.0
Quae Lemnos ardens, quae plaga igniferi poli	qv[ae] le_mno^s a_rde&ns qv[ae] pla^ga& i_gni^fe^ri_ po^li& 	X_^_X_^_^^_^X	0.72
Vetans flagranti currere in zona diem?	ve&ta&ns fla^gra_nti_ cu_rre^re& i&n zo_na_ di^e&m? 	X_^_X_^_X_^X	m
In ipsa me iactate, pro comites, freta	i&n i_psa^ me_ ja&cta_te^ pro_ co^mi^te&s fre^ta& 	X_^_X_^_^^_^X	0.94
Mediosque in amnes - quis sat est Hister mihi?	me^di^o_sqve& i^n a_mne&s qvi&s sa^t e&st hi&ste&r mi^hi& 	^^_^_X_^_X_^X	1.0
Non ipse terris maior Oceanus meos	no&n i_pse^ te_rri&s ma_jo^r o_ce^a^nu&s me^o&s 	X_^_X_^_^^_^X	1.0
Franget uapores, omnis in nostris malis	fra&nge&t va^po_re&s o_mni^s i&n no&stri&s ma^li&s 	X_^_X_^_X_^X	0.8
Deficiet umor, omnis arescet latex.	de&fi^ci^e^t u_mo&r o_mni^s a_re&sce&t la^te&x 	X^^^_X_^_X_^X	0.87
Quid, rector Erebi, me remittebas Ioui?	qvi&d re_cto^r e^re^bi& me_ re^mi_tte&ba&s jo^vi& 	X_^^^X_^_X_^X	1.0
Decuit tenere: redde me tenebris tuis,	de^cu^i&t te^ne_re& re_dde^ me_ te^ne^bri&s tu^i&s 	^^_^_X_^_^^_^X	0.5
Talem subactis Herculem ostende inferis.	ta&le&m su^ba_cti&s he_rcu^le&m o_ste&nde& i_nfe^ri&s 	X_^_X_^_X_^X	1.0
Nil inde ducam, quid times iterum Herculem?	ni&l i_nde^ du_ca&m qvi&d ti^me_s i^te^ru&m he_rcu^le&m 	X_^_X_^_^^_^X	1.0
Inuade, mors, non trepida: iam possum mori.	i&nva_de^ mo&rs no&n tre^pi^da^ ja&m po&ssu&m mo^ri& 	X_^_X^^^_X_^X	1.0
Compesce lacrimas saltem et aerumnas doma	co&mpe_sce^ la^cri^ma&s sa_lte&m e^t [ae]ru&mna_s do^ma& 	X_^^^X_^_X_^X	1.0
Malisque tantis Herculem indomitum refer	ma&li_sqve^ ta_nti&s he_rcu^le&m i_ndo^mi^tu&m re^fe&r 	X_^_X_^_^^_^X	1.0
Mortemque differ: quos soles uince inferos.	mo&rte_mqve^ di_ffe&r qvo&s so^le&s vi&nce& i_nfe^ro&s 	X_^_X_^_X_^X	0.17
Si me catenis horridus uinctum suis	si& me_ ca^te_ni&s ho_rri^du&s vi&nctu&m su^i&s 	X_^_X_^_X_^X	1.0
Praeberet auidae Caucasus uolucri dapem,	pr[ae]be_re^t a^vi^d[ae] c[au]ca^su&s vo^lu^cri_ da^pe&m	X_^^^X_^_^^_^X	m
Scythia gemente flebilis gemitus mihi	scy^thi^a_ ge^me_nte& fle_bi^li&s ge^mi^tu&s mi^hi&	^^_^_X_^_^^_^X	m
Non excidisset; si uagae Symplegades	no&n e_xci^di_sse&t si_ va^g[ae] sy&mple_ga^de&s 	X_^_X_^_X_^X	1.0
Vtraque premerent rupe, redeuntis minas	u&tra_qve^ pre^me^re&nt ru_pe^ re^de^u&nti&s mi^na&s 	X_^^^X_^^^X_^X	0.46
Ferrem ruinae; Pindus incumbat mihi	fe&rre&m ru^i_n[ae] pi_ndu^s i_ncu&mba&t mi^hi& 	X_^_X_^_X_^X	1.0
Atque Haemus et qui Thracios fluctus Athos	a&tqve& h[ae]mu^s e&t qvi& thra_ci^o_s flu&ctu_s a^tho&s 	X_^_X_^_X_^X	0.75
Frangit Iouisque fulmen excipiens Mimas:	fra&ngi&t jo^vi_sqve& fu_lme^n e_xci^pi^e&ns mi^ma&s 	X_^_X_^_^^_^X	0.94
Non ipse si in me, mater, hic mundus ruat	no&n i_pse^ si& i&n me& ma_te^r hi&c mu&ndu&s ru^a&t 	X_^_X_^_X_^X	1.0
Superque nostros flagret incensus toros	su&pe_rqve^ no_stro&s fla_gre^t i_nce&nsu&s to^ro&s 	X_^_X_^_X_^X	1.0
Phoebeus axis, degener mentem Herculis	ph[oe]be_u^s a_xi&s, de_ge^ne&r me_nte&m he_rcu^li&s	X_^_X_^_X_^X	m
Clamor domaret; mille decurrant ferae	cla&mo&r do^ma_re&t mi_lle^ de_cu&rra&nt fe^r[ae] 	X_^_X_^_X_^X	1.0
Pariterque lacerent, hinc feris clangoribus	pa^ri^te_rqve^ la^ce^re&nt hi&nc fe^ri&s cla&ngo_ri^bu&s 	^^_^^^X_^_X_^X	1.0
Aetheria me Stymphalis, hinc taurus minax	[ae]the^ri^a^ me& sty&mpha_li^s hi&nc t[au]ru&s mi^na&x 	X^^^_X_^_X_^X	1.0
Ceruice tota pulset et quidquid fuit	ce&rvi_ce^ to_ta& pu_lse^t e&t qvi&dqvi&d fu^i&t 	X_^_X_^_X_^X	1.0
Solum quoque ingens; surgat hinc illinc nemus	so&lu&m qvo^qve& i_nge&ns su_rga^t hi&nc i&lli&nc ne^mu&s 	X_^_X_^_X_^X	0.93
Artusque nostros dirus immittat Sinis:	a&rtu_sqve^ no_stro&s di_ru^s i_mmi&tta&t si^ni&s 	X_^_X_^_X_^X	1.0
Sparsus silebo - non ferae excutient mihi,	spa&rsu&s si^le_bo& no&n fe^r[ae] e_xcu^ti^e&nt mi^hi& 	X_^_X_^_^^_^X	1.0
Non arma gemitus, nil quod impelli potest.	no&n a_rma^ ge^mi^tu&s ni&l qvo^d i_mpe&lli_ po^te&st 	X_^^^X_^_X_^X	1.0
Non uirus artus, nate, femineum coquit,	no&n vi_ru^s a_rtu&s na_te^ fe_mi^ne^u&m co^qvi&t 	X_^_X_^_^^_^X	1.0
Sed dura series operis et longus tibi	se&d du_ra^ se^ri^e&s o^pe^ri^s e&t lo&ngu&s ti^bi& 	X_^^^X^^^_X_^X	1.0
Pauit cruentos forsitan morbos labor.	p[au]i&t cru^e_nto&s fo_rsi^ta&n mo&rbo&s la^bo&r 	X_^_X_^_X_^X	0.97
Vbi morbus, ubinam est? estne adhuc aliquid mali	u^bi^ mo_rbu^s u^bi^na&m e&st e_stne& a^dhu_c a^li^qvi&d ma^li& 	^^_^^^X_^_^^_^X	0.81
In orbe mecum? ueniat huc - aliquis mihi	i&n o_rbe^ me_cu&m ve^ni^a^t hu_c a^li^qvi&s mi^hi& 	X_^_X^^^_^^_^X	1.0
Intendat arcus: nuda sufficiet manus.	i&nte_nda^t a_rcu&s nu_da^ su_ffi^ci^e&t ma^nu&s 	X_^_X_^_^^_^X	1.0
Excussit illi nimius impulsos dolor.	e&xcu_ssi^t i_lli& ni^mi^u^s i_mpu&lso&s do^lo&r 	X_^_X^^^_X_^X	1.0
Dolor iste furor est: Herculem solus domat.	do^lo^r i_ste^ fu^ro^r e&st he_rcu^le_m so&lu&s do^ma&t 	^^_^^^X_^_X_^X	0.98
Remouete quaeso tela et infestas, precor,	re^mo^ve_te^ qv[ae]so& te_la& e^t i_nfe&sta&s pre^co&r 	^^_^_X_^_X_^X	1.0
Rapite hinc sagittas: igne suffuso genae	ra^pi^te& hi&nc sa^gi_tta&s i_gne^ su_ffu&so_ ge^n[ae] 	^^_^_X_^_X_^X	1.0
Scelus minantur. quas petam latebras anus? -	sce&lu&s mi^na_ntu&r qva&s pe^ta&m la^te^bra_s a^nu&s 	X_^_X_^_^^_^X	0.57
Cur deinde latebras aut fugam uecors petam?	cu&r d[ei]nde^ la^te^bra&s [au]t fu^ga&m ve&co&rs pe^ta&m 	X_^^^X_^_X_^X	0.57
Obire forti meruit Alcmene manu:	o&bi_re^ fo_rti& me^ru^i^t a_lcme&ne_ ma^nu& 	X_^_X^^^_X_^X	1.0
Vel scelere pereat, antequam letum mihi	ve&l sce^le^re^ pe^re^a&t a_nte^qva_m le&tu&m mi^hi& 	X^^^^^X_^_X_^X	1.0
Ignauus aliquis mandat ac turpis manus	i&gn[au]u^s a^li^qvi&s ma_nda^t a&c tu&rpi&s ma^nu&s 	X_^^^X_^_X_^X	1.0
De me triumphat. - ecce lassatus malis	de& me& tri^u_mpha&t e_cce^ la_ssa&tu&s ma^li&s 	X_^_X_^_X_^X	0.92
Sopore fessas alligat uenas dolor	so&po_re^ fe_ssa&s a_lli^ga&t ve&na&s do^lo&r 	X_^_X_^_X_^X	1.0
Grauique anhelum pectus impulsu quatit.	gra&vi_qve& a^nhe_lu&m pe_ctu^s i_mpu&lsu& qva^ti&t 	X_^_X_^_X_^X	1.0
Fauete, superi. si mihi gnatum inclutum	fa&ve_te^ su^pe^ri& si_ mi^hi& gna&tu&m i_nclu^tu&m 	X_^^^X_^_X_^X	1.0
Miserae negastis, uindicem saltem, precor,	mi^se^r[ae] ne^ga_sti&s vi_ndi^ce&m sa&lte&m pre^co&r 	^^_^_X_^_X_^X	1.0
Seruate terris. abeat excussus dolor	se&rva_te^ te_rri&s a^be^a^t e_xcu&ssu&s do^lo&r 	X_^_X^^^_X_^X	1.0
Corpusque uires reparet Herculeum nouas.	co&rpu_sqve^ vi_re&s re^pa^re^t he_rcu^le^u&m no^va&s 	X_^_X^^^_^^_^X	1.0
Pro lux acerba, pro capax scelerum dies!	pro& lu&x a^ce_rba& pro_ ca^pa&x sce^le^ru&m di^e&s 	X_^_X_^_^^_^X	1.0
Nurus Tonantis occidit, natus iacet,	nu&ru&s to^na_nti&s o_cci^di&t na&tu&s ja^ce&t 	X_^_X_^_X_^X	1.0
Nepos supersum; scelere materno hic perit,	ne&po&s su^pe_rsu&m sce^le^re^ ma_te&rno& hi&c pe^ri&t 	X_^_X^^^_X_^X	1.0
Fraude illa capta est - quis per annorum uices	fr[au]de& i_lla^ ca_pta& e&st qvi&s pe^r a_nno&ru&m vi^ce&s 	X_^_X_^_X_^X	1.0
Totoque in aeuo poterit aerumnas senex	to&to_qve& i^n [ae]vo& po^te^ri^t [ae]ru&mna_s se^ne&x 	X_^_X^^^_X_^X	1.0
Referre tantas? unus eripuit dies	re&fe_rre^ ta_nta&s u_nu^s e_ri^pu^i&t di^e&s 	X_^_X_^_^^_^X	1.0
Parentem utrumque; cetera ut sileam mala	pa&re_nte&m u^tru_mqve& ce_te^ra& u&t si^le^a&m ma^la& 	X_^_X_^_^^_^X	0.79
Parcamque fatis, Herculem amitto patrem.	pa&rca_mqve^ fa_ti&s he_rcu^le&m a_mi&tto_ pa^tre&m 	X_^_X_^_X_^X	0.71
Compesce uoces, inclutum Alcidae genus	co&mpe_sce^ vo_ce&s i_nclu^tu&m a_lci&d[ae] ge^nu&s 	X_^_X_^_X_^X	0.99
Miseraeque fato similis Alcmenae nepos:	mi^se^r[ae]qve^ fa_to& si^mi^li^s a_lcme&n[ae] ne^po&s 	^^_^_X^^^_X_^X	1.0
Longus dolorem forsitan uincet sopor.	lo&ngu&s do^lo_re&m fo_rsi^ta&n vi&nce&t so^po&r 	X_^_X_^_X_^X	1.0
Sed ecce, lassam deserit mentem quies	se&d e_cce^ la_ssa&m de_se^ri&t me&nte&m qvi^e&s 	X_^_X_^_X_^X	1.0
Redditque morbo corpus et luctum mihi.	re&ddi_tqve^ mo_rbo& co_rpu^s e&t lu&ctu&m mi^hi& 	X_^_X_^_X_^X	1.0
Quid hoc? rigenti cernitur Trachin iugo	qvi&d ho&c ri^ge_nti& ce_rni^tu&r tra&chi&n ju^go& 	X_^_X_^_X_^X	1.0
An inter astra positus euasi genus	a&n i_nte^r a_stra& po^si^tu^s [eu]a&si_ ge^nu&s 	X_^_X^^^_X_^X	1.0
Mortale tandem? quis mihi caelum parat?	mo&rta_le^ ta_nde&m qvi&s mi^hi_ c[ae]lu&m pa^ra&t 	X_^_X_^_X_^X	0.19
Te te, pater, iam uideo, placatam quoque	te_ te_, pa^te_r, ia_m ui^de^o^, pla_ca_ta&m quo^que& 	X_^_X^^^_X_^X	m
Specto nouercam. quis sonus nostras ferit	spe&cto_ no^ve_rca&m qvi&s so^nu&s no&stra&s fe^ri&t 	X_^_X_^_X_^X	1.0
Caelestis aures? Iuno me generum uocat.	c[ae]le_sti^s [au]re&s ju_no^ me_ ge^ne^ru&m vo^ca&t 	X_^_X_^_^^_^X	0.47
Video nitentem regiam clari aetheris	vi^de^o_ ni^te_nte&m re_gi^a_m cla&ri& [ae]the^ri&s 	^^_^_X_^_X_^X	0.44
Phoebique tritam flammea zonam rota.	ph[oe]bi_qve^ tri_ta&m fla_mme^a& zo&na&m ro^ta& 	X_^_X_^_X_^X	1.0
Cubile uideo Noctis; hinc tenebras uocat.	cu&bi_le^ vi^de^o& no_cti^s hi&nc te^ne^bra&s vo^ca&t 	X_^^^X_^_^^_^X	0.57
Quid hoc? quis axem cludit et ab ipsis, pater,	qvi&d ho&c qvi^s a_xe&m clu_di^t e^t a^b i&psi&s pa^te&r 	X_^_X_^^^X_^X	0.76
Deducit astris? ora Phoebeus modo	de_du_ci^t a_stri_s? o_ra^ ph[oe]be&u&s mo^do&	X_^_X_^_X_^X	m
Afflabat axis, tam prope a caelo fui -	a&ffla_ba^t a_xi&s ta&m pro^pe& a_ c[ae]lo_ fu^i& 	X_^_X_^_X_^X	1.0
Trachina uideo; quis mihi terras dedit?	tra&chi_na^ vi^de^o& qvi&s mi^hi_ te&rra&s de^di&t 	X_^^^X_^_X_^X	0.19
Oete modo infra steterat ac totus fuit	[oe]te_ mo^do& i_nfra& ste^te^ra^t a&c to&tu&s fu^i&t 	X_^_X^^^_X_^X	1.0
Suppositus orbis; tam bene excideras, dolor!	su&ppo^si^tu^s o_rbi&s ta&m be^ne& e_xci^de^ra&s do^lo&r 	X^^^_X_^_^^_^X	1.0
Cogis fateri - parce et hanc uocem occupa.	co&gi&s fa^te_ri& pa_rce& e^t ha&nc vo&ce&m o_ccu^pa& 	X_^_X_^_X_^X	1.0
Haec, Hylle, dona matris? hoc munus parat?	h[ae]c hy_lle^ do_na& ma_tri^s ho&c mu&nu&s pa^ra&t 	X_^_X_^_X_^X	1.0
Vtinam liceret stipite ingesto impiam	u^ti^na&m li^ce_re&t sti_pi^te& i_nge&sto& i_mpi^a&m 	^^_^_X_^_X_^X	1.0
Effringere animam quale Amazonium malum	e&ffri_nge^re& a^ni^ma&m qva_le& a^ma_zo^ni^u_m ma^lu&m 	X_^^^X_^_^^_^X	0.72
Circa niualis Caucasi domui latus.	ci&rca_ ni^va_li&s c[au]ca^si_ do^mu^i_ la^tu&s	X_^_X_^_^^_^X	m
O cara Megara, tune cum furerem mihi	o& ca_ra^ me^ga^ra& tu_ne^ cu&m fu^re^re&m mi^hi&	X_^^^X_^_^^_^X	m
Coniunx fuisti? stipitem atque arcus date,	co&nju&nx fu^i_sti& sti_pi^te&m a_tqve& a&rcu&s da^te& 	X_^_X_^_X_^X	1.0
Dextra inquinetur, laudibus maculam imprimam,	de&xtra& i_nqvi^ne_tu&r l[au]di^bu&s ma^cu^la&m i_mpri^ma&m 	X_^_X_^_^^_^X	1.0
Summus legatur femina Herculeus labor.	su&mmu&s le^ga_tu&r fe_mi^na& he_rcu^le^u&s la^bo&r 	X_^_X_^_^^_^X	0.97
Compesce diras, genitor, irarum minas;	co&mpe_sce^ di_ra&s ge^ni^to^r i_ra&ru&m mi^na&s 	X_^_X^^^_X_^X	0.01
Habet, peractum est, quas petis poenas dedit:	ha&be&t pe^ra_ctu&m e&st qva&s pe^ti&s p[oe]na&s de^di&t 	X_^_X_^_X_^X	1.0
Sua perempta dextera mater iacet.	su&a_ pe^re_mpta& de_xte^ra_ ma&te&r ja^ce&t 	X_^_X_^_X_^X	1.0
Cecidit dolose: manibus irati Herculis	ce^ci^di&t do^lo_se& ma^ni^bu^s i_ra&ti& he_rcu^li&s 	^^_^_X^^^_X_^X	0.64
Occidere meruit; perdidit comitem Lichas.	o&cci^de^re^ me^ru^i&t pe_rdi^di&t co^mi^te&m li^cha&s 	X^^^^^X_^_^^_^X	1.0
Saeuire in ipsum corpus exanime impetus	s[ae]vi_re& i^n i_psu&m co_rpu^s e_xa^ni^me& i_mpe^tu&s 	X_^_X_^_^^_^X	1.0
Atque ira cogit. cur minis nostris caret	a&tqve& i_ra^ co_gi&t cu&r mi^ni&s no&stri&s ca^re&t 	X_^_X_^_X_^X	1.0
Ipsum cadauer? pabulum accipiant ferae.	i&psu&m ca^d[au]e&r pa_bu^lu&m a_cci^pi^a&nt fe^r[ae] 	X_^_X_^_^^_^X	1.0
Plus misera laeso doluit, hinc aliquid quoque	plu&s mi^se^ra^ l[ae]so& do^lu^i^t hi&nc a^li^qvi&d qvo^qve& 	X^^^_X^^^_^^_^X	0.93
Detrahere uelles: occidit dextra sua,	de&tra^he^re^ ve_lle&s o_cci^di&t de&xtra_ su^a& 	X^^^_X_^_X_^X	1.0
Tuo dolore; plura quam poscis tulit.	tu&o_ do^lo_re& plu_ra^ qva&m po&sci&s tu^li&t 	X_^_X_^_X_^X	1.0
Sed non cruentae sceleribus nuptae iaces	se&d no&n cru^e_nt[ae] sce^le^ri^bu_s nu&pt[ae] ja^ce&s 	X_^_X^^^_X_^X	1.0
Nec fraude matris: Nessus hos struxit dolos	ne&c fr[au]de^ ma_tri&s ne_ssu^s ho&s stru&xi&t do^lo&s 	X_^_X_^_X_^X	1.0
Ictus sagittis qui tuis uitam expulit.	i&ctu&s sa^gi_tti&s qvi_ tu^i&s vi&ta&m e_xpu^li&t 	X_^_X_^_X_^X	1.0
Cruore tincta est palla semiferi, pater,	cru&o_re^ ti_ncta& e&st pa_lla^ se_mi^fe^ri_ pa^te&r 	X_^_X_^_^^_^X	1.0
Nessusque nunc has exigit poenas sibi.	ne&ssu_sqve^ nu&nc ha&s e_xi^gi&t p[oe]na&s si^bi& 	X_^_X_^_X_^X	1.0
Bene est, peractum est, fata se nostra explicant;	be&ne& e&st pe^ra_ctu&m e&st fa_ta^ se_ no&stra& e_xpli^ca&nt 	X_^_X_^_X_^X	1.0
Lux ista summa est: quercus hanc sortem mihi	lu&x i_sta^ su_mma& e&st qve_rcu^s ha&nc so&rte&m mi^hi& 	X_^_X_^_X_^X	0.67
Fatidica quondam dederat et Parnassio	fa&ti^di^ca^ qvo_nda&m de^de^ra^t e&t pa&rna_ssi^o& 	X^^^_X^^^_X_^X	1.0
Cirrhaea quatiens templa mugitu nemus:	ci&rrh[ae]a^ qva^ti^e&ns te_mpla^ mu_gi&tu_ ne^mu&s 	X_^^^X_^_X_^X	1.0
"Dextra perempti uictor, Alcide, uiri	de&xtra_ pe^re_mpti& vi_cto^r a_lci&de_ vi^ri& 	X_^_X_^_X_^X	1.0
Olim iacebis; hic tibi emenso freta	o&li&m ja^ce_bi&s hi&c ti^bi& e_me&nso& fre^ta& 	X_^_X_^_X_^X	0.94
Terrasque et umbras finis extremus datur."	te&rra_sqve& e^t u_mbra&s fi_ni^s e_xtre&mu&s da^tu&r 	X_^_X_^_X_^X	0.77
Nil querimur ultra: decuit hunc finem dari,	ni&l qve^ri^mu^r u_ltra& de^cu^i^t hu&nc fi&ne&m da^ri& 	X^^^_X^^^_X_^X	1.0
Ne quis superstes Herculis uictor foret.	ne& qvi&s su^pe_rste&s he_rcu^li&s vi&cto&r fo^re&t 	X_^_X_^_X_^X	1.0
Nunc mors legatur clara memoranda incluta,	nu&nc mo&rs le^ga_tu&r cla_ra^ me^mo^ra&nda& i_nclu^ta& 	X_^_X_^^^X_^X	1.0
Me digna prorsus: nobilem hunc faciam diem.	me& di_gna^ pro_rsu&s no_bi^le&m hu&nc fa^ci^a&m di^e&m 	X_^_X_^_^^_^X	1.0
Caedatur omnis silua et Oetaeum nemus	c[ae]da_tu^r o_mni&s si_lva& e^t [oe]t[ae]u_m ne^mu&s 	X_^_X_^_X_^X	1.0
Succumbat: ingens Herculem accipiat rogus,	su&ccu_mba^t i_nge&ns he_rcu^le&m a_cci^pi^a&t ro^gu&s	X_^_X_^_^^_^X	m
Sed ante mortem. Tu, genus Poeantium,	se&d a_nte^ mo_rte&m tu_ ge^nu&s p[oe]a_nti^u&m 	X_^_X_^_X_^X	1.0
Hoc triste nobis, iuuenis, officium appara:	ho&c tri_ste^ no_bi&s ju^ve^ni^s o_ffi^ci^u&m a_ppa^ra& 	X_^_X^^^_^^_^X	1.0
Herculea totum flamma succendat diem.	he&rcu^le^a^ to_tu&m fla_mma^ su_cce&nda&t di^e&m 	X^^^_X_^_X_^X	1.0
Ad te preces nunc, Hylle, supremas fero:	a&d te& pre^ce&s nu&nc, hy_lle^, su_pre_ma&s fe^ro&: 	X_^_X_^_X_^X	m
Est clara captas inter, in uoltu genus	e&st cla_ra^ ca_pta&s i_nte^r i&n vo&ltu_ ge^nu&s 	X_^_X_^_X_^X	1.0
Regnumque referens, Euryto uirgo edita	re&gnu_mqve^ re^fe^re&ns [eu]ry^to_ vi&rgo& e_di^ta& 	X_^^^X_^_X_^X	1.0
Iole: tuis hanc facibus et thalamis para.	i^o^le_ tu^i_s ha&nc fa^ci^bu^s e&t tha^la^mi&s pa^ra& 	^^_^_X^^^_^^_^X	1.0
Victor cruentus abstuli patriam lares	vi&cto&r cru^e_ntu&s a_bstu^li_ pa^tri^a&m la^re&s	X_^_X_^_^^_^X	m
Nihilque miserae praeter Alciden dedi -	ni&hi_lqve^ mi^se^r[ae] pr[ae]te^r a_lci&de&n de^di& 	X_^^^X_^_X_^X	0.95
Et ipse rapitur. penset aerumnas suas,	e&t i_pse^ ra^pi^tu&r pe_nse^t [ae]ru&mna_s su^a&s 	X_^^^X_^_X_^X	1.0
Iouis nepotem foueat et natum Herculis;	jo&vi&s ne^po_te&m fo^ve^a^t e&t na&tu&m he_rcu^li&s 	X_^_X^^^_X_^X	1.0
Tibi illa pariat quidquid ex nobis habet.	ti^bi& i_lla^ pa^ri^a&t qui_dqui^d e&x no_bi&s ha^be&t. 	X_^^^X_^_X_^X	v
Tuque ipsa planctus pone funereos, precor,	tu&qve& i_psa^ pla_nctu&s po_ne^ fu_ne^re^o&s pre^co&r 	X_^_X_^_^^_^X	1.0
O clara genetrix: uiuet Alcides tibi.	o& cla_ra^ ge^ne^tri&x vi_ve^t a_lci&de&s ti^bi& 	X_^^^X_^_X_^X	1.0
Virtute nostra paelicem feci tuam	vi&rtu_te^ no_stra& p[ae]li^ce_m fe&ci_ tu^a&m 	X_^_X_^_X_^X	1.0
Credi nouercam, siue nascenti Herculi	cre&di_ no^ve_rca&m si_ve^ na_sce&nti& he_rcu^li& 	X_^_X_^_X_^X	1.0
Nox illa certa est siue mortalis meus	no&x i_lla^ ce_rta& e&st si_ve^ mo_rta&li&s me^u&s 	X_^_X_^_X_^X	1.0
Pater est. licet sit falsa progenies mei,	pa^te^r e&st li^ce&t si&t fa_lsa^ pro_ge^ni^e&s me^i& 	^^_^_X_^_^^_^X	0.99
Materna culpa cesset et crimen Iouis,	ma&te_rna^ cu_lpa& ce_sse^t e&t cri&me&n jo^vi&s 	X_^_X_^_X_^X	1.0
Merui parentem: contuli caelo decus,	me^ru^i_ pa^re_nte&m co_ntu^li_ c[ae]lo_ de^cu&s 	^^_^_X_^_X_^X	1.0
Natura me concepit in laudes Iouis.	na&tu_ra^ me_ co&nce_pi^t i&n l[au]de&s jo^vi&s 	X_^_X_^_X_^X	1.0
Quin ipse, quamquam Iuppiter, credi meus	qvi&n i_pse^ qva_mqva&m ju_ppi^te&r cre&di_ me^u&s 	X_^_X_^_X_^X	1.0
Pater esse gaudet; parce iam lacrimis, parens:	pa^te^r e_sse^ g[au]de&t pa_rce^ ja&m la^cri^mi&s pa^re&ns 	^^_^_X_^_^^_^X	0.93
Superba matres inter Argolicas eris.	su&pe_rba^ ma_tre&s i_nte^r a_rgo^li^ca_s e^ri&s 	X_^_X_^_^^_^X	1.0
Quid tale Iuno genuit aetherium gerens	qvi&d ta_le^ ju_no& ge^nu^i^t [ae]the^ri^u&m ge^re&ns 	X_^_X^^^_^^_^X	1.0
Sceptrum et Tonanti nupta? mortali tamen	sce&ptru&m e&t to^na_nti& nu_pta^ mo_rta&li_ ta^me&n 	X_^_X_^_X_^X	1.0
Caelum tenens inuidit, Alciden suum	c[ae]lu&m te^ne&ns i&nvi_di^t a_lci&de&n su^u&m 	X_^_X_^_X_^X	1.0
Dici esse uoluit. Perage nunc, Titan, uices	di&ci& e_sse^ uo^lu^i&t. pe^ra^ge^ nu&nc, ti&ta_n, ui^ce&s	X_^^^X^^^_X_^X	m
Solus relictus: ille qui uester comes	so&lu&s re^li_ctu&s i_lle^ qvi_ ve&ste&r co^me&s 	X_^_X_^_X_^X	1.0
Vbique fueram, Tartara et manes peto.	u&bi_qve^ fu^e^ra&m ta_rta^ra& e&t ma&ne&s pe^to& 	X_^^^X_^_X_^X	1.0
Hanc tamen ad imos perferam laudem inclutam,	ha&nc ta^me^n a^d i_mo&s pe_rfe^ra&m l[au]de&m i_nclu^ta&m 	X^^^_X_^_X_^X	1.0
Quod nulla pestis fudit Alciden palam	qvo&d nu_lla^ pe_sti&s fu_di^t a_lci&de&n pa^la&m 	X_^_X_^_X_^X	1.0
Omnemque pestem uicit Alcides palam.	o&mne_mqve^ pe_ste&m vi_ci^t a_lci&de&s pa^la&m 	X_^_X_^_X_^X	1.0
Effare casus, iuuenis, Herculeos precor	e&ffa_re^ ca_su&s ju^ve^ni^s he_rcu^le^o&s pre^co&r 	X_^_X^^^_^^_^X	1.0
Voltuue quonam tulerit Alcides necem.	vo&ltu_ve^ qvo_na&m tu^le^ri^t a_lci&de&s ne^ce&m 	X_^_X^^^_X_^X	1.0
Quo nemo uitam. Laetus adeone ultimos	qvo& ne_mo^ vi_ta&m l[ae]tu^s a^de^o&ne& u_lti^mo&s 	X_^_X_^^^X_^X	0.5
Inuasit ignes? Esse iam flammas nihil	i&nva_si^t i_gne&s e_sse^ ja&m fla&mma&s ni^hi&l 	X_^_X_^_X_^X	1.0
Ostendit ille. quid sub hoc mundo Hercules	o&ste_ndi^t i_lle& qvi&d su^b ho&c mu&ndo& he_rcu^le&s 	X_^_X_^_X_^X	1.0
Immune uinci liquit? en domita omnia.	i&mmu_ne^ vi_nci& li_qvi^t e&n do^mi^ta& o_mni^a& 	X_^_X_^_^^_^X	1.0
Inter uapores quis fuit forti locus?	i&nte&r va^po_re&s qvi&s fu^i&t fo&rti_ lo^cu&s 	X_^_X_^_X_^X	1.0
Quod unum in orbe uicerat nondum malum,	qvo&d u_nu&m i^n o_rbe& vi_ce^ra&t no&ndu&m ma^lu&m 	X_^_X_^_X_^X	0.72
Et flamma uicta est; haec quoque accessit feris:	e&t fla_mma^ vi_cta& e&st h[ae]c qvo^qve& a_cce&ssi&t fe^ri&s 	X_^_X_^_X_^X	0.93
Inter labores ignis Herculeos abit.	i&nte&r la^bo_re&s i_gni^s he_rcu^le^o_s a^bi&t 	X_^_X_^_^^_^X	0.91
Edissere agedum, flamma quo uicta est modo?	e&di_sse^re& a^ge^du&m fla_mma^ qvo_ vi&cta& e&st mo^do& 	X_^^^X_^_X_^X	1.0
Vt omnis Oeten maesta corripuit manus,	u&t o_mni^s [oe]te&n m[ae]sta^ co_rri^pu^i&t ma^nu&s 	X_^_X_^_^^_^X	0.87
Huic fagus umbras perdit et toto iacet	hu&jc fa_gu^s u_mbra&s pe_rdi^t e&t to&to_ ja^ce&t 	X_^_X_^_X_^X	1.0
Succisa trunco, flectit hic pinum ferox	su&cci_sa^ tru_nco& fle_cti^t hi&c pi&nu&m fe^ro&x 	X_^_X_^_X_^X	1.0
Astris minantem et nube de media uocat:	a&stri&s mi^na_nte&m e&t nu_be^ de_ me^di^a_ vo^ca&t	X_^_X_^_^^_^X	m
Ruitura cautem mouit et siluam tulit	ru^i^tu_ra^ c[au]te&m mo_vi^t e&t si&lva&m tu^li&t 	^^_^_X_^_X_^X	1.0
Secum minorem. Chaonis quondam loquax	se&cu&m mi^no_re&m cha_o^ni&s qvo&nda&m lo^qva&x 	X_^_X_^_X_^X	1.0
Stat uasta late quercus et Phoebum uetat	sta&t va_sta^ la_te& qve_rcu^s e&t ph[oe]bu&m ve^ta&t 	X_^_X_^_X_^X	0.65
Vltraque totos porrigit ramos nemus;	u&ltra_qve^ to_to&s po_rri^gi&t ra&mo&s ne^mu&s 	X_^_X_^_X_^X	1.0
Gemit illa multo uulnere impresso minax	ge^mi^t i_lla^ mu_lto& vu_lne^re& i_mpre&sso_ mi^na&x 	^^_^_X_^_X_^X	1.0
Frangitque cuneos, resilit incussus chalybs	fra&ngi_tqve^ cu^ne^o&s re^si^li^t i_ncu&ssu&s cha^ly&bs 	X_^^^X^^^_X_^X	1.0
Volnusque ferrum patitur et rigidum est parum.	vo&lnu_sqve^ fe_rru&m pa^ti^tu^r e&t ri^gi^du&m e&st pa^ru&m	X_^_X^^^_^^_^X	m
Commota tandem cum cadens latam sui	co&mmo_ta^ ta_nde&m cu&m ca^de&ns la&ta&m su^i& 	X_^_X_^_X_^X	1.0
Duxit ruinam, protinus radios locus	du&xi&t ru^i_na&m pro_ti^nu&s ra^di^o&s lo^cu&s 	X_^_X_^_^^_^X	1.0
Admisit omnis: sedibus pulsae suis	a&dmi_si^t o_mni&s se_di^bu&s pu&lsae& su^i&s 	X_^_X_^_X_^X	1.0
Volucres pererrant nemore succiso diem	vo^lu^cre&s pe^re_rra&nt ne^mo^re^ su_cci&so_ di^e&m 	^^_^_X^^^_X_^X	0.59
Quaeruntque lassis garrulae pinnis domus.	qv[ae]ru_ntqve^ la_ssi&s ga_rru^lae_ pi&nni&s do^mu&s 	X_^_X_^_X_^X	1.0
Iamque omnis arbor sonuit et sacrae quoque	ja&mqve& o_mni^s a_rbo&r so^nu^i^t e&t sa&cr[ae] qvo^qve& 	X_^_X^^^_X_^X	0.8
Sensere quercus horridam ferro manum	se&nse_re^ qve_rcu&s ho_rri^da&m fe&rro_ ma^nu&m 	X_^_X_^_X_^X	1.0
Nullique priscum profuit luco nemus.	nu&lli_qve^ pri_scu&m pro_fu^i&t lu&co_ ne^mu&s 	X_^_X_^_X_^X	1.0
Aggeritur omnis silua et alternae trabes	a&gge^ri^tu^r o_mni&s si_lva& e^t a_lte&rn[ae] tra^be&s 	X^^^_X_^_X_^X	1.0
In astra tollunt Herculi angustum rogum:	i&n a_stra^ to_llu&nt he_rcu^li& a_ngu&stu&m ro^gu&m 	X_^_X_^_X_^X	1.0
Raptura flammas pinus et robur tenax	ra&ptu_ra^ fla_mma&s pi_nu^s e&t ro&bu&r te^na&x 	X_^_X_^_X_^X	0.83
Et breuior ilex. summa sed complet rogum	e&t bre^vi^o^r i_le&x su_mma^ se&d co&mple&t ro^gu&m 	X^^^_X_^_X_^X	1.0
Populea silua, frondis Herculeae nemus.	po&pu^le^a^ si_lva& fro_ndi^s he_rcu^le^[ae] ne^mu&s 	X^^^_X_^_^^_^X	1.0
At ille, ut ingens nemore sub Nasamonio	a&t i_lle& u^t i_nge&ns ne^mo^re^ su&b na^sa^mo_ni^o&	X_^_X^^^_^^_^X	m
Aegro reclinis pectore immugit leo,	[ae]gro_ re^cli_ni&s pe_cto^re& i_mmu&gi&t le^o& 	X_^_X_^_X_^X	0.5
Fertur - quis illum credat ad flammas rapi?	fe&rtu&r qvi^s i_llu&m cre_da^t a&d fla&mma&s ra^pi& 	X_^_X_^_X_^X	0.76
Voltus petentis astra, non ignes erat.	vo&ltu&s pe^te_nti&s a_stra^ no_n i&gne_s e^ra&t 	X_^_X_^_X_^X	1.0
Vt pressit Oeten ac suis oculis rogum	u&t pre_ssi^t [oe]te&n a&c su^i_s o^cu^li&s ro^gu&m	X_^_X_^_^^_^X	m
Lustrauit omnem, fregit impositus trabes.	lu&str[au]i^t o_mne&m fre_gi^t i_mpo^si^tu&s tra^be&s 	X_^_X_^_^^_^X	1.0
Arcumque poscit. "accipe haec" inquit, "sate	a&rcu_mqve^ po_sci&t a_cci^pe& h[ae]c i&nqvi&t sa^te& 	X_^_X_^_X_^X	1.0
Poeante, dona, et munus Alcidae cape.	p[oe]a_nte^ do_na& e&t mu_nu^s a_lci&d[ae] ca^pe& 	X_^_X_^_X_^X	1.0
Has hydra sensit, his iacent Stymphalides	ha&s hy_dra^ se_nsi&t hi&s ja^ce&nt sty&mpha_li^de&s 	X_^_X_^_X_^X	1.0
Et quidquid aliud eminus uici manu	e&t qvi_dqvi^d a^li^u&d e_mi^nu&s vi&ci_ ma^nu& 	X_^^^X_^_X_^X	1.0
Victrice. felix iuuenis has numquam irritas	vi&ctri_ce^ fe_li&x ju^ve^ni^s ha&s nu&mqva&m i_rri^ta&s 	X_^_X^^^_X_^X	1.0
Mittes in hostem, siue de media uoles	mi&tte_s i^n ho_ste&m si_ve^ de_ me^di^a_ vo^le&s	X_^_X_^_^^_^X	m
Auferre uolucres nube, descendent aues	[au]fe_rre^ vo^lu^cre&s nu_be^ de_sce&nde&nt a^ve&s 	X_^^^X_^_X_^X	0.59
Et certa praedae tela de caelo fluent,	e&t ce_rta^ pr[ae]d[ae] te_la^ de_ c[ae]lo& flu^e&nt 	X_^_X_^_X_^X	1.0
Nec fallet umquam dexteram hic arcus tuam:	ne&c fa_lle^t u_mqva&m de_xte^ra&m hi_c a&rcu&s tu^a&m 	X_^_X_^_X_^X	0.99
Librare telum didicit et certam dare	li&bra_re^ te_lu&m di^di^ci^t e&t ce&rta&m da^re& 	X_^_X^^^_X_^X	1.0
Fugam sagittis, ipsa non fallunt iter	fu&ga&m sa^gi_tti&s i_psa^ no&n fa&llu&nt i^te&r 	X_^_X_^_X_^X	1.0
Emissa neruo tela; tu tantum, precor,	e&mi_ssa^ ne_rvo& te_la^ tu_ ta&ntu&m pre^co&r 	X_^_X_^_X_^X	1.0
Accommoda ignes et facem extremam mihi.	a&cco_mmo^da& i_gne&s e&t fa^ce&m e_xtre&ma&m mi^hi& 	X_^_X_^_X_^X	1.0
Hic nodus" inquit, "nulla quem cepit manus,	hi&c no_du^s i_nqvi&t nu_lla^ qve&m ce&pi&t ma^nu&s 	X_^_X_^_X_^X	1.0
Mecum per ignes flagret; hoc telum Herculem	me&cu&m pe^r i_gne&s fla_gre^t ho&c te&lu&m he_rcu^le&m 	X_^_X_^_X_^X	1.0
Tantum sequetur. hoc quoque acciperes" ait	ta&ntu&m se^qve_tu&r ho&c qvo^qve& a_cci^pe^re_s a^i&t	X_^_X_^_^^_^X	m
"Si ferre posses. adiuuet domini rogum."	si& fe_rre^ po_sse&s a_dju^ve&t do^mi^ni_ ro^gu&m 	X_^_X_^_^^_^X	1.0
Tum rigida secum spolia Nemeaei mali	tu&m ri^gi^da^ se_cu&m spo^li^a^ ne^me^[ae]i_ ma^li& 	X^^^_X^^^^^X_^X	0.82
Arsura poscit; latuit in spolio rogus.	a&rsu_ra^ po_sci&t la^tu^i^t i&n spo^li^o_ ro^gu&s 	X_^_X^^^_^^_^X	1.0
Ingemuit omnis turba nec lacrimas dolor	i&nge^mu^i^t o_mni&s tu_rba^ ne&c la^cri^ma&s do^lo&r	X^^^_X_^_^^_^X	m
Cuiquam remisit. mater in luctum furens	cu&jqva&m re^mi_si&t ma_te^r i&n lu&ctu&m fu^re&ns 	X_^_X_^_X_^X	1.0
Diduxit auidum pectus atque utero tenus	di&du_xi^t a^vi^du&m pe_ctu^s a_tqve& u^te^ro_ te^nu&s 	X_^^^X_^_^^_^X	1.0
Exerta uastos ubera in planctus ferit,	e&xe_rta^ va_sto&s u_be^ra& i&n pla&nctu&s fe^ri&t 	X_^_X_^_X_^X	1.0
Superosque et ipsum uocibus pulsans Iouem	su^pe^ro_sqve& e^t i_psu&m vo_ci^bu&s pu&lsa&ns jo^ve&m 	^^_^_X_^_X_^X	1.0
Impleuit omnem uoce feminea locum.	i&mpl[eu]i^t o_mne&m vo_ce^ fe_mi^ne^a_ lo^cu&m	X_^_X_^_^^_^X	m
"Deforme letum, mater, Herculeum facis,	de&fo_rme^ le_tu&m ma_te^r he_rcu^le^u&m fa^ci&s 	X_^_X_^_^^_^X	1.0
Compesce lacrimas" inquit, "introrsus dolor	co&mpe_sce^ la^cri^ma&s i_nqvi^t i_ntro&rsu&s do^lo&r 	X_^^^X_^_X_^X	1.0
Femineus abeat; Iuno cur laetum diem	fe&mi^ne^u^s a^be^a&t ju_no^ cu&r l[ae]tu&m di^e&m 	X^^^^^X_^_X_^X	0.47
Te flente ducat? paelicis gaudet suae	te& fle_nte^ du_ca&t p[ae]li^ci&s g[au]de&t su^[ae] 	X_^_X_^_X_^X	1.0
Spectare lacrimas. comprime infirmum iecur,	spe&cta_re^ la^cri^ma&s co_mpri^me& i_nfi&rmu&m je^cu&r 	X_^^^X_^_X_^X	1.0
Mater: nefas est ubera atque uterum tibi	ma&te&r ne^fa_s e&st u_be^ra& a_tqve& u^te^ru&m ti^bi& 	X_^_X_^_^^_^X	1.0
Laniare, qui me genuit." et dirum fremens,	la^ni^a_re^ qvi_ me& ge^nu^i^t e&t di&ru&m fre^me&ns 	^^_^_X^^^_X_^X	1.0
Qualis per urbes duxit Argolicas canem,	qva&li&s pe^r u_rbe&s du_xi^t a_rgo^li^ca&s ca^ne&m 	X_^_X_^_^^_^X	1.0
Cum uictor Erebi Dite contempto redit	cu&m vi_cto^r e^re^bi& di_te^ co_nte&mpto_ re^di&t 	X_^^^X_^_X_^X	1.0
Tremente fato, talis incubuit rogo.	tre&me_nte^ fa_to& ta_li^s i_ncu^bu^i&t ro^go&	X_^_X_^_^^_^X	m
Quis sic triumphans laetus in curru stetit	qvi&s si&c tri^u_mpha&ns l[ae]tu^s i&n cu&rru& ste^ti&t 	X_^_X_^_X_^X	1.0
Victor? quis illo gentibus uultu dedit	vi&cto&r qvi^s i_llo& ge_nti^bu&s vu&ltu_ de^di&t 	X_^_X_^_X_^X	0.76
Leges tyrannus? quanta pax habitum tulit!	le&ge&s ty^ra_nnu&s qva_nta^ pa&x ha^bi^tu&m tu^li&t 	X_^_X_^_^^_^X	1.0
Haesere lacrimae, cecidit impulsus dolor	h[ae]se_re^ la^cri^m[ae] ce^ci^di^t i_mpu&lsu&s do^lo&r 	X_^^^X^^^_X_^X	0.97
Nobis quoque ipsis, nemo periturum ingemit:	no&bi&s qvo^qve& i_psi&s ne_mo^ pe^ri^tu&ru&m i_nge^mi&t 	X_^_X_^^^X_^X	0.46
Iam flere pudor est; ipsa quam sexus iubet	ja&m fle_re^ pu^do^r e&st i_psa^ qva&m se&xu&s ju^be&t 	X_^^^X_^_X_^X	1.0
Maerere, siccis haesit Alcmene genis	m[ae]re_re^ si_cci&s h[ae]si^t a_lcme&ne_ ge^ni&s 	X_^_X_^_X_^X	1.0
Stetitque nato paene iam similis parens.	ste&ti_tqve^ na_to& p[ae]ne^ ja&m si^mi^li&s pa^re&ns 	X_^_X_^_^^_^X	0.97
Nullasne in astra misit ad superos preces	nu&lla_sne& i^n a_stra& mi_si^t a&d su^pe^ro&s pre^ce&s 	X_^_X_^_^^_^X	1.0
Arsurus aut in uota respexit Iouem?	a&rsu_ru^s [au]t i&n vo_ta^ re_spe&xi&t jo^ve&m 	X_^_X_^_X_^X	1.0
Iacuit sui securus et caelum intuens	ja^cu^i&t su^i_ se&cu_ru^s e&t c[ae]lu&m i_ntu^e&ns 	^^_^_X_^_X_^X	1.0
Quaesiuit oculis, arce an ex aliqua pater	qv[ae]si_vi^t o^cu^li&s a_rce& a^n e&x a^li^qva_ pa^te&r	X_^^^X_^_^^_^X	m
Despiceret illum. tum manus tendens ait:	de&spi^ce^re^t i_llu&m tu&m ma^nu&s te&nde&ns a^i&t 	X^^^_X_^_X_^X	1.0
"Quacumque parte prospicis natum, pater,	qva&cu_mqve^ pa_rte& pro_spi^ci&s na&tu&m pa^te&r 	X_^_X_^_X_^X	1.0
Te te precor, cui nocte commissa dies	te& te& pre^co&r cu&j no_cte^ co_mmi&ssa_ di^e&s 	X_^_X_^_X_^X	1.0
Quieuit unus, si meas laudes canit	qvi&[eu]i^t u_nu&s si_ me^a&s l[au]de&s ca^ni&t 	X_^_X_^_X_^X	1.0
Vtrumque Phoebi litus et Scythiae genus	u&tru_mqve^ ph[oe]bi& li_tu^s e&t scy^thi^[ae] ge^nu&s 	X_^_X_^_^^_^X	1.0
Et omnis ardens ora quam torret dies,	e&t o_mni^s a_rde&ns o_ra^ qva&m to&rre&t di^e&s 	X_^_X_^_X_^X	0.87
Si pace tellus plena, si nullae gemunt	si& pa_ce^ te_llu&s ple_na^ si_ nu&ll[ae] ge^mu&nt 	X_^_X_^_X_^X	1.0
Vrbes nec aras impias quisquam inquinat,	u&rbe&s ne^c a_ra&s i_mpi^a&s qvi&sqva&m i_nqvi^na&t 	X_^_X_^_X_^X	1.0
Si scelera desunt, spiritum admitte hunc, precor,	si& sce^le^ra^ de_su&nt spi_ri^tu&m a_dmi&tte& hu&nc pre^co&r 	X^^^_X_^_X_^X	1.0
In astra. non me noctis infernae locus	i&n a_stra^ no&n me& no_cti^s i_nfe&rn[ae] lo^cu&s 	X_^_X_^_X_^X	1.0
Nec maesta nigri regna conterrent Iouis,	ne&c m[ae]sta^ ni_gri& re_gna^ co_nte&rre&nt jo^vi&s 	X_^_X_^_X_^X	1.0
Sed ire ad illos umbra, quos uici, deos,	se&d i_re& a^d i_llo&s u_mbra^ qvo&s vi&ci_ de^o&s 	X_^_X_^_X_^X	1.0
Pater, erubesco. nube discussa diem	pa^te^r e_ru^be_sco& nu_be^ di_scu&ssa_ di^e&m	^^_^_X_^_X_^X	m
Pande, ut deorum coetus ardentem Herculem	pa&nde& u&t de^o_ru&m c[oe]tu^s a_rde&nte&m he_rcu^le&m 	X_^_X_^_X_^X	0.4
Spectet; licet tu sidera et mundum neges	spe&cte&t li^ce&t tu& si_de^ra& e&t mu&ndu&m ne^ge&s 	X_^_X_^_X_^X	1.0
Vltro, pater, cogere: si uoces dolor	u&ltro_ pa^te&r co&ge_re^ si_ vo&ce&s do^lo&r 	X_^_X_^_X_^X	0.25
Abstulerit ullas, pande tunc Stygios lacus	a&bstu^le^ri^t u_lla&s pa_nde^ tu&nc sty^gi^o&s la^cu&s 	X^^^_X_^_^^_^X	1.0
Et redde fatis; approba natum prius:	e&t re_dde^ fa_ti&s a_ppro^ba_ na&tu&m pri^u&s 	X_^_X_^_X_^X	1.0
Vt dignus astris uidear, hic faciet dies.	u&t di_gnu^s a_stri&s vi^de^a^r hi&c fa^ci^e&t di^e&s 	X_^_X^^^_^^_^X	1.0
Leue est quod actum est; Herculem hic, genitor, dies	le&ve& e&st qvo^d a_ctu&m e&st he_rcu^le&m hi&c ge^ni^to&r di^e&s 	X_^_X_^_^^_^X	1.0
Inueniet aut damnabit." Haec postquam edidit,	i&nve^ni^e^t [au]t da&mna_bi^t h[ae]c po&stqva&m e_di^di&t 	X^^^_X_^_X_^X	1.0
Flammas poposcit. "hoc age, Alcidae comes,	fla&mma&s po^po_sci&t ho_c a^ge& a_lci&d[ae] co^me&s 	X_^_X_^_X_^X	1.0
Non segnis" inquit "corripe Oetaeam facem.	no&n se_gni^s i_nqvi&t co_rri^pe& [oe]t[ae]a_m fa^ce&m 	X_^_X_^_X_^X	1.0
Quid dextra tremuit? num manus pauida impium	qvi&d de_xtra^ tre^mu^i&t nu&m ma^nu&s pa^vi^da& i_mpi^u&m 	X_^^^X_^_^^_^X	1.0
Scelus refugit? redde iam pharetras mihi,	sce&lu&s re^fu_gi&t re_dde^ ja&m pha^re^tra&s mi^hi& 	X_^_X_^_^^_^X	0.25
Ignaue iners eneruis - en nostros manus	i&gn[au]e& i^ne&rs e&ne_rvi^s e&n no&stro&s ma^nu&s 	X_^_X_^_X_^X	1.0
Quae tendat arcus! quid sedet pallor genis?	qv[ae] te_nda^t a_rcu&s qvi&d se^de&t pa&llo&r ge^ni&s 	X_^_X_^_X_^X	1.0
Animo faces inuade quo Alciden uides	a^ni^mo_ fa^ce_s i&nva_de^ qvo& a_lci&de&n vi^de&s 	^^_^_X_^_X_^X	0.98
Voltu iacere. respice arsurum, miser:	vo&ltu_ ja^ce_re& re_spi^ce& a_rsu&ru&m mi^se&r 	X_^_X_^_X_^X	0.67
Nouerca cernat quo feram flammas modo.	no&ve_rca^ ce_rna&t qvo_ fe^ra&m fla&mma&s mo^do& 	X_^_X_^_X_^X	1.0
Vocat ecce iam me genitor et pandit polos;	vo^ca^t e_cce^ ja&m me& ge^ni^to^r e&t pa&ndi&t po^lo&s 	^^_^_X^^^_X_^X	0.01
Venio, pater" - uultusque non idem fuit.	ve^ni^o_ pa^te&r vu&ltu_sqve^ no_n i&de&m fu^i&t 	^^_^_X_^_X_^X	1.0
Tremente pinum dextera ardentem intuli.	tre&me_nte^ pi_nu&m de_xte^ra& a_rde&nte&m i_ntu^li& 	X_^_X_^_X_^X	1.0
Refugit ignis et reluctantur faces	re&fu_gi^t i_gni&s e&t re^lu_cta&ntu_r fa^ce&s 	X_^_X_^_X_^X	0.83
Et membra uitant, sed recedentem Hercules	e&t me_mbra^ vi_ta&nt se&d re^ce_de&nte&m he_rcu^le&s 	X_^_X_^_X_^X	1.0
Insequitur ignem. Caucasum aut Pindum aut Athon	i&nse^qvi^tu^r i_gne&m c[au]ca^su&m [au]t pi&ndu&m [au]t a^tho&n 	X^^^_X_^_X_^X	1.0
Ardere credas: nullus erumpit sonus,	a&rde_re^ cre_da&s nu_llu^s e_ru&mpi&t so^nu&s 	X_^_X_^_X_^X	1.0
Tantum ingemiscit ignis. o durum iecur!	ta&ntu&m i_nge^mi_sci&t i_gni^s o_ du&ru&m je^cu&r 	X_^_X_^_X_^X	0.91
Typhon in illo positus immanis rogo	ty&pho_n i^n i_llo& po^si^tu^s i_mma&ni&s ro^go& 	X_^_X^^^_X_^X	1.0
Gemuisset ipse quique conuulsam solo	ge^mu^i_sse^t i_pse& qvi_qve^ co_nvu&lsa&m so^lo& 	^^_^_X_^_X_^X	0.71
Imposuit umeris Ossan Enceladus ferox.	i&mpo^su^i^t u^me^ri&s o_ssa^n e_nce^la^du&s fe^ro&x 	X^^^^^X_^_^^_^X	1.0
At ille medias inter exurgens faces,	a&t i_lle^ me^di^a&s i_nte^r e_xu&rge_ns fa^ce&s 	X_^^^X_^_X_^X	0.98
Semiustus ac laniatus, intrepidum tuens:	se^mi^u_stu^s a&c la^ni^a_tu^s i_ntre^pi^du&m tu^e&ns	^^_^_^^_^_^^_^X	m
"Nunc es parens Herculea: sic stare ad rogum	nu&nc e&s pa^re&ns he&rcu^le^a^ si&c sta&re& a&d ro^gu&m 	X_^_X^^^_X_^X	0.97
Te, mater" inquit, "sic decet fleri Herculem."	te& ma_te^r i_nqvi&t si&c de^ce&t fle&ri& he_rcu^le&m 	X_^_X_^_X_^X	1.0
Inter uapores positus et flammae minas	i&nte&r va^po_re&s po^si^tu^s e&t fla&mm[ae] mi^na&s 	X_^_X^^^_X_^X	1.0
Immotus, inconcussus, in neutrum latus	i&mmo_tu^s i_nco&ncu_ssu^s i&n ne^u^tru&m la^tu&s 	X_^_X_^_^^_^X	0.98
Correpta torquens membra adhortatur, monet,	co&rre_pta^ to_rqve&ns me_mbra& a^dho_rta&tu_r mo^ne&t 	X_^_X_^_X_^X	1.0
Gerit aliquid ardens. omnibus fortem addidit	ge^ri^t a^li^qvi^d a_rde&ns o_mni^bu&s fo&rte&m a_ddi^di&t 	^^^^^_X_^_X_^X	1.0
Animum ministris; urere ardentem putes.	a^ni^mu&m mi^ni_stri&s u_re^re& a_rde&nte&m pu^te&s 	^^_^_X_^_X_^X	1.0
Stupet omne uulgus, uix habent flammae fidem:	stu^pe^t o_mne^ vu_lgu&s vi&x ha^be&nt fla&mm[ae] fi^de&m 	^^_^_X_^_X_^X	1.0
Tam placida frons est, tanta maiestas uiro.	ta&m pla^ci^da^ fro&ns e&st ta_nta^ ma_je&sta&s vi^ro& 	X^^^_X_^_X_^X	1.0
Nec properat uri; cumque iam forti datum	ne&c pro^pe^ra^t u_ri& cu_mqve^ ja&m fo&rti_ da^tu&m 	X^^^_X_^_X_^X	1.0
Leto satis pensauit, igniferas trabes	le&to_ sa^ti&s pe&ns[au]i^t i_gni^fe^ra&s tra^be&s 	X_^_X_^_^^_^X	1.0
Hinc inde traxit, minima quas flamma occupat	hi&nc i_nde^ tra_xi&t mi^ni^ma^ qva&s fla&mma& o_ccu^pa&t 	X_^_X^^^_X_^X	1.0
Totas in ignes uertit et quis plurimus	to&ta_s i^n i_gne&s ve_rti^t e&t qvi&s plu_ri^mu&s 	X_^_X_^_X_^X	1.0
Exundat ignis repetit intrepidus ferox.	e&xu_nda^t i_gni&s re^pe^ti^t i_ntre^pi^du&s fe^ro&x 	X_^_X^^^_^^_^X	1.0
Tunc ora flammis implet: ast illi graues	tu&nc o_ra^ fla_mmi&s i_mple^t a&st i&lli& gra^ve&s 	X_^_X_^_X_^X	1.0
Luxere barbae; cumque iam uultum minax	lu&xe_re^ ba_rb[ae] cu_mqve^ ja&m vu&ltu&m mi^na&x 	X_^_X_^_X_^X	1.0
Appeteret ignis, lamberent flammae caput,	a&ppe^te^re^t i_gni&s la_mbe^re&nt fla&mm[ae] ca^pu&t 	X^^^_X_^_X_^X	1.0
Non pressit oculos. Sed quid hoc? maestam intuor	no&n pre_ssi^t o^cu^lo&s se&d qvi^d ho&c m[ae]sta&m i_ntu^o&r 	X_^^^X_^_X_^X	1.0
Sinu gerentem reliquias magni Herculis,	si&nu_ ge^re_nte&m re^li^qui^a&s ma_gni& he_rcu^li&s, 	X_^_X^^^_X_^X	m
Crinemque iactans squalidum Alcmene gemit.	cri&ne_mqve^ ja_cta&ns sqva_li^du&m a_lcme&ne_ ge^mi&t 	X_^_X_^_X_^X	1.0
Timete, superi, fata: tam paruus cinis	ti&me_te^ su^pe^ri& fa_ta^ ta&m pa&rvu&s ci^ni&s 	X_^^^X_^_X_^X	1.0
Herculeus, huc huc ille decreuit gigas!	he&rcu^le^u^s hu_c hu&c i_lle^ de_cr[eu]i&t gi^ga&s 	X^^^_X_^_X_^X	1.0
O quanta, Titan, in nihil moles abit;	o& qva_nta^ ti_ta&n i&n ni^hi&l mo&le_s a^bi&t 	X_^_X_^_X_^X	1.0
Anilis, heu me, recipit Alciden sinus,	a&ni_li^s h[eu] me& re^ci^pi^t a_lci&de&n si^nu&s 	X_^_X^^^_X_^X	1.0
Hic cumulus ille est: ecce uix totam Hercules	hi&c cu^mu^lu^s i_lle& e&st e_cce^ vi&x to&ta&m he_rcu^le&s 	X^^^_X_^_X_^X	1.0
Compleuit urnam; quam leue est pondus mihi,	co&mpl[eu]i^t u_rna&m qva&m le^ve& e&st po&ndu&s mi^hi& 	X_^_X_^_X_^X	0.92
Cui totus aether pondus incubuit leue!	cu&j to_tu^s [ae]the&r po_ndu^s i_ncu^bu^i&t le^ue&	X_^_X_^_^^_^X	m
Ad Tartara olim regnaque, o nate, ultima	a&d ta_rta^ra& o_li&m re_gna^qve& o_ na&te& u_lti^ma& 	X_^_X_^_X_^X	1.0
Rediturus ibas - quando ab inferna Styge	re^di^tu_ru^s i_ba&s qva_ndo& a^b i_nfe&rna& sty^ge& 	^^_^_X_^_X_^X	1.0
Remeabis iterum? non ut et spolium trahas	re^me^a_bi^s i^te^ru&m no_n u^t e&t spo^li^u&m tra^ha&s	^^_^^^X_^_^^_^X	m
Rursusque Theseus debeat lucem tibi -	ru&rsu_sqve^ the_s[eu]s de_be^a&t lu&ce&m ti^bi& 	X_^_X_^_X_^X	1.0
Sed quando solus? mundus impositus tuas	se&d qva_ndo^ so_lu&s mu_ndu^s i_mpo^si^tu&s tu^a&s 	X_^_X_^_^^_^X	0.47
Compescet umbras teque Tartareus canis	co&mpe_sce^t u_mbra&s te_qve^ ta_rta^re^u&s ca^ni&s 	X_^_X_^_^^_^X	0.4
Inhibere poterit? quando Taenarias fores	i^nhi^be_re^ po^te^ri&t qva_ndo^ t[ae]na^ri^a_s fo^re&s 	^^_^^^X_^_^^_^X	0.47
Pulsabis? aut quas mater ad fauces agar	pu&lsa_bi^s [au]t qva&s ma_te^r a&d f[au]ce_s a^ga&r 	X_^_X_^_X_^X	1.0
Qua mors aditur? uadis ad manes iter	qva& mo&rs a^di_tu&r va_di^s a&d ma&ne_s i^te&r 	X_^_X_^_X_^X	0.12
Habiturus unum. quid diem questu tero?	ha^bi^tu_ru^s u_nu&m qvi&d di^e&m qve&stu_ te^ro& 	^^_^_X_^_X_^X	1.0
Quid misera duras uita? quid lucem hanc tenes?	qvi&d mi^se^ra^ du_ra&s vi_ta^ qvi&d lu&ce&m ha&nc te^ne&s 	X^^^_X_^_X_^X	1.0
Quem parere rursus Herculem possum Ioui?	que&m pa^re^re^ ru_rsu&s he_rcu^le&m po_ssu&m jo^ui_? 	X^^^_X_^_X_^X	m
Quis me parentem natus Alcmenen suam	qvi&s me_ pa^re_nte&m na_tu^s a_lcme&ne_n su^a&m 	X_^_X_^_X_^X	1.0
Tantus uocabit? o nimis felix, nimis,	ta&ntu&s vo^ca_bi&t o_ ni^mi&s fe&li&x ni^mi&s 	X_^_X_^_X_^X	1.0
Thebane coniunx, Tartari intrasti loca	the&ba_ne^ co_nju&nx ta_rta^ri& i_ntra&sti_ lo^ca& 	X_^_X_^_X_^X	1.0
Florente nato teque uenientem inferi	flo&re_nte^ na_to& te_qve^ ve^ni^e&nte&m i_nfe^ri& 	X_^_X_^^^X_^X	1.0
Timuere forsan, quod pater tanti Herculis,	ti^mu^e_re^ fo_rsa&n qvo&d pa^te&r ta&nti& he_rcu^li&s 	^^_^_X_^_X_^X	1.0
Vel falsus, aderas. Quas petam terras anus,	ve&l fa_lsu^s a^de^ra&s qva&s pe^ta&m te&rra_s a^nu&s 	X_^^^X_^_X_^X	1.0
Inuisa saeuis regibus (si quis tamen	i&nvi_sa^ s[ae]vi&s re_gi^bu&s si& qvi&s ta^me&n 	X_^_X_^_X_^X	1.0
Rex est relictus saeuus? ei miserae mihi!	re&x e&st re^li_ctu&s s[ae]vu^s [ei] mi^se^r[ae] mi^hi& 	X_^_X_^_^^_^X	1.0
Quicumque caesos ingemunt nati patres,	qvi&cu_mqve^ c[ae]so&s i_nge^mu&nt na&ti_ pa^tre&s 	X_^_X_^_X_^X	0.41
A me petent supplicia, me cuncti obruent:	a& me_ pe^te&nt su&ppli^ci^a^ me_ cu&ncti& o_bru^e&nt 	X_^_X^^^_X_^X	1.0
Si quis minor Busiris aut si quis minor	si& qvi&s mi^no&r bu&si_ri^s [au]t si& qvi&s mi^no&r 	X_^_X_^_X_^X	1.0
Antaeus urbes feruidae terret plagae,	a_nt[ae]u^s u_rbe&s fe_rui^d[ae] te_rre&t pla^g[ae], 	X_^_X_^_X_^X	m
Ego praeda ducar; si quis Ismarius greges	e^go^ pr[ae]da^ du_ca&r si& qvi^s i_sma^ri^u_s gre^ge&s 	^^_^_X_^_^^_^X	0.76
Thracis cruenti uindicat, carpent greges	thra&ci&s cru^e_nti& vi_ndi^ca&t ca&rpe&nt gre^ge&s 	X_^_X_^_X_^X	1.0
Mea membra diri; forsitan poenas petet	me^a^ me_mbra^ di_ri& fo_rsi^ta&n p[oe]na&s pe^te&t 	^^_^_X_^_X_^X	1.0
Irata Iuno: totus exurget dolor;	i&ra_ta^ ju_no& to_tu^s e_xu&rge_t do^lo&r 	X_^_X_^_X_^X	1.0
Secura uicto tandem ab Alcide uacat,	se&cu_ra^ vi_cto& ta_nde&m a^b a_lci&de_ va^ca&t 	X_^_X_^_X_^X	1.0
Paelex supersum - quanta supplicia expetet	p[ae]le&x su^pe_rsu&m qva_nta^ su_ppli^ci^a& e_xpe^te&t 	X_^_X_^_^^_^X	1.0
Ne parere possim! fecit hic natus mihi	ne_ pa^re^re^ po_ssi&m! fe_ci^t hi&c na_tu&s mi^hi& 	X^^^_X_^_X_^X	m
Vterum timendum. Quae petam Alcmene loca?	u^te^ru&m ti^me_ndu&m qv[ae] pe^ta&m a_lcme&ne_ lo^ca& 	^^_^_X_^_X_^X	1.0
Quis me locus, quae regio, quae mundi plaga	qui&s me_ lo^cu&s, qu[ae] re^gi^o^, qu[ae] mu_ndi& pla^ga& 	X_^_X^^^_X_^X	m
Defendet aut quas mater in latebras agar	de&fe_nde^t [au]t qva&s ma_te^r i&n la^te^bra_s a^ga&r 	X_^_X_^_^^_^X	0.57
Vbique per te nota? si patriam petam	u&bi_qve^ pe&r te& no_ta^ si_ pa^tri^a&m pe^ta&m 	X_^_X_^_^^_^X	0.95
Laresque miseros, Argos Eurystheus tenet;	la&re_sqve^ mi^se^ro&s a_rgo^s [eu]ry&sth[eu]s te^ne&t 	X_^^^X_^_X_^X	0.78
Marita Thebas regna et Ismenon petam	ma&ri_ta^ the_ba&s re_gna& e^t i_sme&no&n pe^ta&m 	X_^_X_^_X_^X	1.0
Thalamosque nostros, in quibus quondam Iouem	tha^la^mo_sqve^ no_stro&s i&n qvi^bu&s qvo&nda&m jo^ve&m 	^^_^_X_^_X_^X	1.0
Dilecta uidi? pro nimis felix, nimis,	di&le_cta^ vi_di& pro_ ni^mi&s fe&li&x ni^mi&s 	X_^_X_^_X_^X	1.0
Si fulminantem et ipsa sensissem Iouem!	si& fu_lmi^na_nte&m e&t i_psa^ se_nsi&sse&m jo^ve&m 	X_^_X_^_X_^X	1.0
Vtinam meis uisceribus Alcides foret	u^ti^na&m me^i&s vi&sce^ri^bu^s a_lci&de&s fo^re&t 	^^_^_X^^^_X_^X	1.0
Exsectus infans! nunc datum est tempus, datum est	e&xse_ctu^s i_nfa&ns nu&nc da^tu&m e&st te&mpu&s da^tu&m e&st 	X_^_X_^_X_^X	1.0
Videre natum laude certantem Ioui,	vi&de_re^ na_tu&m l[au]de^ ce_rta&nte&m jo^vi& 	X_^_X_^_X_^X	1.0
Vt hoc daretur, scire quid fatum mihi	u&t ho&c da^re_tu&r sci_re^ qvi&d fa&tu&m mi^hi& 	X_^_X_^_X_^X	0.97
Eripere posset. quis memor uiuit tui,	e&ri^pe^re^ po_sse&t qvi&s me^mo&r vi&vi&t tu^i& 	X^^^_X_^_X_^X	1.0
O nate, populus? omne iam ingratum est genus.	o& na_te^ po^pu^lu&s o_mne^ ja&m i_ngra&tu&m e&st ge^nu&s	X_^^^X_^_X_^X	m
Petam Cleonas? Arcadum an populos petam	pe&ta&m cle^o_na&s a_rca^du&m a&n po^pu^lo&s pe^ta&m 	X_^_X_^_^^_^X	1.0
Meritisque terram nobilem quaeram tuis?	me^ri^ti_sqve^ te_rra&m no_bi^le&m qv[ae]ra&m tu^i&s 	^^_^_X_^_X_^X	1.0
Hic dira serpens cecidit, hic ales fera,	hi&c di_ra^ se_rpe&ns ce^ci^di^t hi_c a&le&s fe^ra& 	X_^_X^^^_X_^X	0.96
Hic sus cruentus, hic tua fractus manu	hi&c su&s cru^e_ntu&s hi&c tu^a_ fra&ctu&s ma^nu& 	X_^_X_^_X_^X	1.0
Qui te sepulto possidet caelum leo:	qvi& te_ se^pu_lto& po_ssi^de&t c[ae]lu&m le^o& 	X_^_X_^_X_^X	1.0
Si grata terra est, populus Alcmenen tuam	si& gra_ta^ te_rra& e&st po^pu^lu^s a_lcme&ne_n tu^a&m 	X_^_X^^^_X_^X	0.84
Defendat omnis. Thracias gentes petam	de&fe_nda^t o_mni&s thra_ci^a_s ge&nte&s pe^ta&m 	X_^_X_^_X_^X	1.0
Hebrique populos? haec quoque est meritis tuis	he&bri_qve^ po^pu^lo&s h[ae]c qvo^qve& e&st me^ri^ti&s tu^i&s 	X_^^^X_^_^^_^X	0.93
Defensa tellus: stabula cum regno iacent.	de&fe_nsa^ te_llu&s sta^bu^la^ cu&m re&gno_ ja^ce&nt 	X_^_X^^^_X_^X	1.0
Hic pax cruento rege prostrato data est:	hi&c pa&x cru^e_nto& re_ge^ pro_stra&to_ da^ta& e&st 	X_^_X_^_X_^X	0.93
Vbi enim negata est? Quod tibi infelix anus	u^bi& e^ni&m ne^ga_ta& e&st qvo&d ti^bi& i_nfe&li&x a^nu&s 	^^_^_X_^_X_^X	1.0
Quaeram sepulcrum? de tuis totus rogis	qv[ae]ra&m se^pu_lcru&m de_ tu^i&s to&tu&s ro^gi&s 	X_^_X_^_X_^X	1.0
Contendat orbis. reliquias magni Herculis	co_nte_nda^t o_rbi&s. re^li^qui^a&s ma_gni& he_rcu^li&s 	X_^_X^^^_X_^X	m
Quis populus aut quae templa, quae gentes rogant?	qvi&s po^pu^lu^s [au]t qv[ae] te_mpla^ qv[ae] ge&nte&s ro^ga&nt 	X^^^_X_^_X_^X	0.84
Quis, quis petit, quis poscit Alcmenes onus?	qvi&s qvi&s pe^ti&t qvi&s po_sci^t a_lcme&ne_s o^nu&s 	X_^_X_^_X_^X	1.0
Quae tibi sepulcra, nate, quis tumulus sat est?	qv[ae] ti^bi^ se^pu_lcra& na_te^ qvi&s tu^mu^lu&s sa^t e&st 	X^^^_X_^_^^_^X	0.85
Hic totus orbis: fama erit titulus tibi.	hi&c to_tu^s o_rbi&s fa_ma& e^ri&t ti^tu^lu&s ti^bi& 	X_^_X_^_^^_^X	1.0
Quid, anime, trepidas? Herculis cineres tenes;	qvi&d a^ni^me^ tre^pi^da&s he_rcu^li&s ci^ne^re&s te^ne&s 	X^^^^^X_^_^^_^X	1.0
Complectere ossa: reliquiae auxilium dabunt,	co_mple_cte^re& o_ssa&: re^li^qui^ae [au]xi^li^u&m da^bu&nt, 	X_^_X^^^_^^_^X	m
Erunt satis praesidia, terrebunt tuae	e&ru&nt sa^ti&s pr[ae]si^di^a^ te_rre&bu&nt tu^[ae] 	X_^_X^^^_X_^X	1.0
Reges uel umbrae. Debitos nato quidem	re&ge&s ve^l u_mbr[ae] de_bi^to&s na&to& qvi^de&m 	X_^_X_^_X_^X	1.0
Compesce fletus, mater Alcidae incluti.	co&mpe_sce^ fle_tu&s ma_te^r a_lci&d[ae] i_nclu^ti& 	X_^_X_^_X_^X	1.0
Non est gemendus nec graui urgendus prece,	no&n e&st ge^me_ndu&s ne&c gra^vi& u_rge&ndu_s pre^ce& 	X_^_X_^_X_^X	1.0
Virtute quisquis abstulit fatis iter:	vi&rtu_te^ qvi_sqvi&s a_bstu^li&t fa&ti_s i^te&r 	X_^_X_^_X_^X	1.0
Aeterna uirtus Herculem fleri uetat:	[ae]te_rna^ vi_rtu&s he_rcu^le_m fle&ri_ ve^ta&t 	X_^_X_^_X_^X	1.0
Fortes uetant maerere, degeneres iubent.	fo&rte&s ve^ta&nt m[ae]re_re^ de_ge^ne^re&s ju^be&nt 	X_^_X_^_^^_^X	1.0
Sedabo questus uindice amisso parens	se&da_bo^ qve_stu&s vi_ndi^ce& a_mi&sso_ pa^re&ns 	X_^_X_^_X_^X	0.97
Vtrumque clara spectat Oceanum rota?	u&tru_mqve^ cla_ra& spe_cta^t o_ce^a^nu&m ro^ta& 	X_^_X_^_^^_^X	1.0
Quot misera in uno condidi natos parens!	qvo&t mi^se^ra& i^n u_no& co_ndi^di_ na&to&s pa^re&ns 	X^^^_X_^_X_^X	0.97
Regno carebam, regna sed poteram dare.	re&gno_ ca^re_ba&m re_gna^ se&d po^te^ra&m da^re& 	X_^_X_^_^^_^X	1.0
Vna inter omnes terra quas matres gerit	u&na& i_nte^r o_mne&s te_rra^ qva&s ma&tre&s ge^ri&t 	X_^_X_^_X_^X	1.0
Votis peperci, nil ego a superis peti,	vo&ti&s pe^pe_rci& ni_l e^go& a_ su^pe^ri&s pe^ti&	X_^_X_^_^^_^X	v
Incolume nato: quid dare Herculeus mihi	i&nco^lu^me^ na_to& qvi&d da^re& he_rcu^le^u&s mi^hi& 	X^^^_X_^_^^_^X	1.0
Non poterat ardor, quod deus quisquam mihi	no&n po^te^ra^t a_rdo&r qvo&d de^u&s qvi&sqva&m mi^hi& 	X^^^_X_^_X_^X	1.0
Negare poterat? uota in hac fuerant manu:	ne&ga_re^ po^te^ra&t vo_ta& i^n ha&c fu^e^ra&nt ma^nu& 	X_^^^X_^_^^_^X	1.0
Quidquid negaret Iuppiter, daret Hercules.	qvi&dqvi&d ne^ga_re&t ju_ppi^te&r da^re^t he_rcu^le&s 	X_^_X_^_^^_^X	1.0
Quid tale genetrix ulla mortalis tulit?	qvi&d ta_le^ ge^ne^tri&x u_lla^ mo_rta&li&s tu^li&t 	X_^^^X_^_X_^X	1.0
Deriguit aliqua mater, ut toto stetit	de&ri^gu^i^t a^li^qva& ma_te^r u&t to&to& ste^ti&t 	X^^^^^X_^_X_^X	1.0
Succisa fetu, bisque septenos gregem	su&cci_sa^ fe_tu& bi_sqve^ se_pte&no&s gre^ge&m 	X_^_X_^_X_^X	1.0
Deplanxit una: gregibus aequari meus	de&pla_nxi^t u_na& gre^gi^bu^s [ae]qva&ri_ me^u&s 	X_^_X^^^_X_^X	1.0
Quot ille poterat! matribus miseris adhuc	qvo&t i_lle^ po^te^ra&t ma_tri^bu&s mi^se^ri_s a^dhu&c	X_^^^X_^_^^_^X	m
Exemplar ingens derat: Alcmene dabo.	e&xe_mpla^r i_nge&ns de_ra^t a_lcme&ne_ da^bo& 	X_^_X_^_X_^X	1.0
Cessate, matres, pertinax si quas dolor	ce&ssa_te^ ma_tre&s pe_rti^na_x si& qva&s do^lo&r 	X_^_X_^_X_^X	1.0
Adhuc iubet lugere, quas luctus grauis	a&dhu&c ju^be&t lu&ge_re^ qva&s lu&ctu&s gra^vi&s 	X_^_X_^_X_^X	1.0
In saxa uertit; cedite his cunctae malis.	i&n sa_xa^ ve_rti&t ce_di^te& hi&s cu&nct[ae] ma^li&s 	X_^_X_^_X_^X	0.92
Agedum senile pectus, o miserae manus,	a^ge^du&m se^ni_le& pe_ctu^s o_ mi^se^r[ae] ma^nu&s 	^^_^_X_^_^^_^X	1.0
Pulsate - et una funeri tanto sat est	pu&lsa_te& e^t u_na& fu_ne^ri_ ta&nto_ sa^t e&st 	X_^_X_^_X_^X	1.0
Grandaeua anus defecta, quod totus breui	gra&nd[ae]va& a^nu&s de&fe_cta^ qvo&d to&tu&s bre^vi& 	X_^_X_^_X_^X	1.0
Iam quaeret orbis? expedi in planctus tamen	ja&m qv[ae]re^t o_rbi&s e_xpe^di& i&n pla&nctu&s ta^me&n 	X_^_X_^_X_^X	1.0
Defessa quamquam bracchia: inuidiam ut deis	de&fe_ssa^ qva_mqva&m bra_cchi^a& i_nvi^di^a&m u&t de^i&s 	X_^_X_^_^^_^X	1.0
Lugendo facias, aduoca in planctus genus.	lu&ge_ndo^ fa^ci^a&s a_dvo^ca& i&n pla&nctu&s ge^nu&s 	X_^^^X_^_X_^X	1.0
Quid me tenentem regna siderei poli	qvi&d me_ te^ne_nte&m re_gna^ si_de^re^i_ po^li& 	X_^_X_^_^^_^X	1.0
Caeloque tandem redditum planctu iubes	c[ae]lo_qve^ ta_nde&m re_ddi^tu&m pla&nctu_ ju^be&s 	X_^_X_^_X_^X	1.0
Sentire fatum? parce: iam uirtus mihi	se&nti_re^ fa_tu&m pa_rce^ ja&m vi&rtu&s mi^hi& 	X_^_X_^_X_^X	0.97
In astra et ipsos fecit ad superos iter.	i&n a_stra& e^t i_pso&s fe_ci^t a&d su^pe^ro_s i^te&r 	X_^_X_^_^^_^X	1.0
Non me gementis stagna Cocyti tenent	no&n me_ ge^me_nti&s sta_gna^ co_cy&ti_ te^ne&nt 	X_^_X_^_X_^X	1.0
Nec puppis umbras furua transuexit meas;	ne&c pu_ppi^s u_mbra&s fu_rva^ tra_nsve&xi_t me^a&s 	X_^_X_^_X_^X	0.89
Iam parce, mater, questibus: manes semel	ja&m pa_rce^ ma_te&r qve_sti^bu&s ma&ne&s se^me&l 	X_^_X_^_X_^X	0.97
Vmbrasque uidi; quidquid in nobis tui	u&mbra_sqve^ vi_di& qvi_dqvi^d i&n no&bi&s tu^i& 	X_^_X_^_X_^X	1.0
Mortale fuerat, ignis euictum tulit:	mo&rta_le^ fu^e^ra&t i_gni^s [eu]i&ctu&m tu^li&t 	X_^^^X_^_X_^X	0.91
Paterna caelo, pars data est flammis tua.	pa&te_rna^ c[ae]lo& pa&rs da^ta& e&st fla&mmi&s tu^a& 	X_^_X_^_X_^X	1.0
Proinde planctus pone, quos nato paret	pro^i_nde^ pla_nctu&s po_ne^, quo&s na&to_ pa^re&t 	X_^_X_^_X_^X	m
Genetrix inerti; luctus in turpes eat:	ge^ne^tri&x i^ne_rti& lu_ctu^s i&n tu&rpe_s e^a&t 	^^_^_X_^_X_^X	0.57
Virtus in astra tendit, in mortem timor.	vi&rtu_s i^n a_stra& te_ndi^t i&n mo&rte&m ti^mo&r 	X_^_X_^_X_^X	1.0
Praesens ab astris, mater, Alcides cano:	pr[ae]se&ns a^b a_stri&s ma_te^r a_lci&de&s ca^no& 	X_^_X_^_X_^X	0.5
Poenas cruentus iam tibi Eurystheus dabit;	p[oe]na&s cru^e_ntu&s ja&m ti^bi& [eu]ry&sth[eu]s da^bi&t 	X_^_X_^_X_^X	1.0
Curru superbum uecta transcendes caput.	cu&rru_ su^pe_rbu&m ve_cta^ tra_nsce&nde&s ca^pu&t 	X_^_X_^_X_^X	1.0
Me iam decet subire caelestem plagam:	me& ja&m de^ce&t su&bi_re^ c[ae]le&ste&m pla^ga&m 	X_^_X_^_X_^X	0.5
Inferna uici rursus Alcides loca.	i&nfe_rna^ vi_ci& ru_rsu^s a_lci&de&s lo^ca& 	X_^_X_^_X_^X	1.0
Mane parumper - cessit ex oculis, abit,	ma&ne_ pa^ru_mpe&r ce_ssi^t e&x o^cu^li_s a^bi&t 	X_^_X_^_^^_^X	0.5
In astra fertur. fallor an uultus putat	i&n a_stra^ fe_rtu&r fa_llo^r a&n vu&ltu&s pu^ta&t 	X_^_X_^_X_^X	1.0
Vidisse natum? misera mens incredula est.	vi&di_sse^ na_tu&m mi^se^ra^ me&ns i&ncre_du^la& e&st 	X_^_X^^^_X_^X	1.0
Es numen et te mundus aeternum tenet:	e&s nu_me^n e&t te& mu_ndu^s [ae]te&rnu&m te^ne&t 	X_^_X_^_X_^X	1.0
Credo triumphis. - regna Thebarum petam	cre&do& tri^u_mphi&s re_gna^ the_ba&ru&m pe^ta&m 	X_^_X_^_X_^X	1.0
Nouumque templis additum numen canam.	no&vu_mqve^ te_mpli&s a_ddi^tu&m nu&me&n ca^na&m 	X_^_X_^_X_^X	0.83
