/*
Created by Aleksandr Fedchin on 9/1/2019.
This is the complete scansion of trimeter sections of Seneca's Troades
The edition used is that of O. Zwierlein, 1986, source:mqdq.it
MqDq version was modified whenever there were typos (lines 792, 991).
Estimated accuracy: 98%

Each line contains a verse from the original text, a list of words from that
verse with their inferred scansions, the scansion itself, and one of the
following tags:
    'm' - if the line was manually scanned
    'v' - if automatically produced scansion was manually verified
    'c' - if automatically produced scansion was corrected
    'u' - if the line was left unscanned
    confidence score that the program assigns to the line (higher=better)

Key:
X - monosyllabic anceps (can also be marked as _ or ^ wherever the line is
	scanned manually)
_ - long syllable
^ - short syllable
& - the quantity is unknown (for elided syllables, anceps syllables,
	or syllables long by position)
Resolution rate: 0.851
Resolution rate in lines in which speakers remain the same: 0.85
Resolution rate in lines in which speakers change: 0.875
*/

Quicumque regno fidit et magna potens	qvi&cu_mqve^ re_gno& fi_di^t e&t ma&gna_ po^te&ns 	X_^_X_^_X_^X	1.0
Dominatur aula nec leues metuit deos	do^mi^na_tu^r [au]la& ne&c le^ve&s me^tu^i&t de^o&s 	^^_^_X_^_^^_^X	0.97
Animumque rebus credulum laetis dedit,	a^ni^mu_mqve^ re_bu&s cre_du^lu&m l[ae]ti&s de^di&t 	^^_^_X_^_X_^X	1.0
Me uideat et te, Troia: non umquam tulit	me& vi^de^a^t e&t te& tro_ja^ no_n u&mqva&m tu^li&t 	X^^^_X_^_X_^X	0.68
Documenta fors maiora, quam fragili loco	do^cu^me_nta^ fo&rs ma&jo_ra^ qva&m fra^gi^li_ lo^co& 	^^_^_X_^_^^_^X	1.0
Starent superbi. columen euersum occidit	sta&re&nt su^pe_rbi& co^lu^me^n [eu]e&rsu&m o_cci^di&t 	X_^_X^^^_X_^X	1.0
Pollentis Asiae, caelitum egregius labor;	po&lle_nti^s a^si^[ae] c[ae]li^tu&m e_gre^gi^u&s la^bo&r 	X_^^^X_^_^^_^X	0.97
Ad cuius arma uenit et qui frigidum	a&d cu_ju^s a_rma& ve_ni^t e&t qvi& fri_gi^du&m 	X_^_X_^_X_^X	0.43
Septena Tanain ora pandentem bibit	se&pte_na^ ta^na^i&n o_ra^ pa_nde&nte&m bi^bi&t 	X_^^^X_^_X_^X	1.0
Et qui renatum primus excipiens diem	e&t qvi_ re^na_tu&m pri_mu^s e_xci^pi^e&ns di^e&m 	X_^_X_^_^^_^X	0.99
Tepidum rubenti Tigrin inmiscet freto,	te^pi^du&m ru^be_nti& ti_gri^n i_nmi&sce_t fre^to& 	^^_^_X_^_X_^X	1.0
Et quae uagos uicina prospiciens Scythas	e&t qv[ae] va^go&s vi&ci_na^ pro_spi^ci^e&ns scy^tha&s 	X_^_X_^_^^_^X	1.0
Ripam cateruis Ponticam uiduis ferit,	ri&pa&m ca^te_rvi&s po_nti^ca&m vi^du^i&s fe^ri&t	X_^_X_^_^^_^X	c
Excisa ferro est; Pergamum incubuit sibi.	e&xci_sa^ fe_rro& e&st pe_rga^mu&m i_ncu^bu^i&t si^bi& 	X_^_X_^_^^_^X	1.0
En alta muri decora congestis iacent	e&n a_lta^ mu_ri& de^co^ra^ co_nge&sti&s ja^ce&nt 	X_^_X^^^_X_^X	0.69
Tectis adusti; regiam flammae ambiunt	te&cti_s a^du_sti& re_gi^a_m fla&mm[ae] a_mbi^u&nt 	X_^_X_^_X_^X	1.0
Omnisque late fumat Assaraci domus.	o&mni_sqve^ la_te& fu_ma^t a_ssa^ra^ci_ do^mu&s 	X_^_X_^_^^_^X	0.98
Non prohibet auidas flamma uictoris manus:	no&n pro^hi^be^t a^vi^da&s fla_mma^ vi_cto&ri&s ma^nu&s 	X^^^^^X_^_X_^X	1.0
Diripitur ardens Troia, nec caelum patet	di&ri^pi^tu^r a_rde&ns tro_ja^ ne&c c[ae]lu&m pa^te&t 	X^^^_X_^_X_^X	0.68
Vndante fumo: nube ceu densa obsitus	u&nda_nte^ fu_mo& nu_be^ c[eu] de&nsa& o_bsi^tu&s 	X_^_X_^_X_^X	1.0
Ater fauilla squalet Iliaca dies.	a&te&r fa^vi_lla& sqva_le^t i_li&a^ca^ di^e&s	X_^_X_^_X^^^X	m
Stat auidus irae uictor et lentum Ilium	sta&t a^vi^du^s i_r[ae] vi_cto^r e&t le&ntu&m i_li^u&m 	X^^^_X_^_X_^X	1.0
Metitur oculis ac decem tandem ferus	me&ti_tu^r o^cu^li&s a&c de^ce&m ta&nde&m fe^ru&s 	X_^^^X_^_X_^X	1.0
Ignoscit annis; horret afflictam quoque,	i&gno_sci^t a_nni&s ho_rre^t a_ffli&cta&m qvo^qve& 	X_^_X_^_X_^X	0.93
Victamque quamuis uideat, haut credit sibi	vi&cta_mqve^ qva_mvi&s vi^de^a^t h[au]t cre&di&t si^bi& 	X_^_X^^^_X_^X	1.0
Potuisse uinci. spolia populator rapit	po^tu^i_sse^ vi_nci& spo^li^a^ po^pu^la&to&r ra^pi&t 	^^_^_X^^^^^X_^X	1.0
Dardania; praedam mille non capiunt rates.	da&rda^ni^a^ pr[ae]da&m mi_lle^ no&n ca^pi^u&nt ra^te&s 	X^^^_X_^_^^_^X	1.0
Testor deorum numen aduersum mihi	te&sto&r de^o_ru&m nu_me^n a_dve&rsu&m mi^hi& 	X_^_X_^_X_^X	1.0
Patriaeque cineres teque rectorem Phrygum	pa^tri^[ae]qve^ ci^ne^re&s te_qve^ re_cto&re&m phry^gu&m 	^^_^^^X_^_X_^X	1.0
Quem Troia toto conditum regno tegit,	qve&m tro_ja^ to_to& co_ndi^tu&m re&gno_ te^gi&t 	X_^_X_^_X_^X	0.68
Tuosque manes quo stetit stante Ilium,	tu&o_sqve^ ma_ne&s qvo& ste^ti&t sta&nte& i_li^u&m 	X_^_X_^_X_^X	1.0
Et uos meorum liberum magni greges,	e&t vo&s me^o_ru&m li_be^ru_m ma&gni& gre^ge&s 	X_^_X_^_X_^X	1.0
Vmbrae minores: quidquid aduersi accidit,	u&mbr[ae] mi^no_re&s qvi_dqvi^d a_dve&rsi& a_cci^di&t 	X_^_X_^_X_^X	1.0
Quaecumque Phoebas ore lymphato furens	qv[ae]cu_mqve^ ph[oe]ba&s o_re^ ly_mpha&to_ fu^re&ns 	X_^_X_^_X_^X	1.0
Credi deo uetante praedixit mala,	cre&di_ de^o_ ve&ta_nte^ pr[ae]di&xi&t ma^la& 	X_^_X_^_X_^X	0.94
Prior Hecuba uidi grauida nec tacui metus	pri^o^r he^cu^ba^ vi_di& gra^vi^da^ ne&c ta^cu^i_ me^tu&s 	^^^^^_X^^^_^^_^X	1.0
Et uana uates ante Cassandram fui.	e&t va_na^ va_te&s a_nte^ ca_ssa&ndra_m fu^i& 	X_^_X_^_X_^X	1.0
Non cautus ignes Ithacus aut Ithaci comes	no&n c[au]tu^s i_gne&s i^tha^cu^s [au]t i^tha^ci_ co^me&s	X_^_X^^^_^^_^X	m
Nocturnus in uos sparsit aut fallax Sinon:	no&ctu_rnu^s i&n vo&s spa_rsi^t [au]t fa&lla&x si^no&n 	X_^_X_^_X_^X	1.0
Meus ignis iste est, facibus ardetis meis.	me^u^s i_gni^s i_ste& e&st fa^ci^bu^s a_rde&ti&s me^i&s 	^^_^_X^^^_X_^X	0.91
Sed quid ruinas urbis euersae gemis,	se&d qvi&d ru^i_na&s u_rbi^s [eu]e&rs[ae] ge^mi&s 	X_^_X_^_X_^X	1.0
Viuax senectus? respice infelix ad hos	vi&va&x se^ne_ctu&s re_spi^ce& i_nfe&li&x a^d ho&s 	X_^_X_^_X_^X	1.0
Luctus recentes: Troia iam uetus est malum.	lu&ctu&s re^ce_nte&s tro_ja^ ja&m ve^tu^s e&st ma^lu&m 	X_^_X_^_^^_^X	0.49
Vidi execrandum regiae caedis nefas	vi&di& e_xe^cra_ndu&m re_gi^[ae] c[ae]di&s ne^fa&s 	X_^_X_^_X_^X	1.0
Ipsasque ad aras maius admissum scelus,	i&psa_sqve& a^d a_ra&s ma_ju^s a_dmi&ssu&m sce^lu&s 	X_^_X_^_X_^X	1.0
Aeacius armis cum ferox, saeua manu	[ae]a^ci^u^s a_rmi&s cu&m fe^ro&x s[ae]va_ ma^nu& 	X^^^_X_^_X_^X	1.0
Coma reflectens regium torta caput,	co&ma_ re^fle_cte&ns re_gi^u&m to&rta_ ca^pu&t 	X_^_X_^_X_^X	1.0
Alto nefandum uulneri ferrum abdidit;	a&lto_ ne^fa_ndu&m vu_lne^ri_ fe&rru&m a_bdi^di&t 	X_^_X_^_X_^X	1.0
Quod penitus actum cum recepisset libens,	qvo&d pe^ni^tu^s a_ctu&m cu&m re^ce_pi&sse&t li^be&ns 	X^^^_X_^_X_^X	1.0
Ensis senili siccus e iugulo redit.	e&nsi&s se^ni_li& si_ccu^s e_ ju^gu^lo_ re^di&t 	X_^_X_^_^^_^X	1.0
Placare quem non potuit a caede effera	pla&ca_re^ qve&m no&n po^tu^i^t a_ c[ae]de& e_ffe^ra& 	X_^_X^^^_X_^X	1.0
Mortalis aeui cardinem extremum premens	mo&rta_li^s [ae]vi& ca_rdi^ne&m e_xtre&mu&m pre^me&ns 	X_^_X_^_X_^X	1.0
Superique testes sceleris et quoddam sacrum	su^pe^ri_qve^ te_ste&s sce^le^ri^s e&t qvo&dda_m sa^cru&m 	^^_^_X^^^_X_^X	0.32
Regni iacentis? ille tot regum parens	re&gni_ ja^ce_nti&s i_lle^ to&t re&gu&m pa^re&ns 	X_^_X_^_X_^X	0.97
Caret sepulcro Priamus et flamma indiget	ca&re&t se^pu_lcro& pri^a^mu^s e&t fla&mma& i_ndi^ge&t 	X_^_X^^^_X_^X	1.0
Ardente Troia. Non tamen superis sat est:	a&rde_nte^ tro_ja& no&n ta^me&n su^pe^ri&s sa^t e&st	X_^_X_^_^^_^X	m
Dominum ecce Priami nuribus et natis legens	do^mi^nu&m e_cce^ pri^a^mi& nu^ri^bu^s e&t na&ti&s le^ge&ns 	^^_^^^X^^^_X_^X	1.0
Sortitur urna, praedaque en uilis sequar.	so&rti_tu^r u_rna& pr[ae]da^qve& e&n vi&li&s se^qva&r 	X_^_X_^_X_^X	1.0
Hic Hectoris coniugia despondet sibi,	hi&c he_cto^ri&s co&nju^gi^a^ de_spo&nde&t si^bi& 	X_^_X^^^_X_^X	1.0
Hic optat Heleni coniugem, hic Antenoris;	hi&c o_pta^t he^le^ni& co_nju^ge&m hi_c a&nte_no^ri&s 	X_^^^X_^_X_^X	0.99
Nec dest tuos, Cassandra, qui thalamos petat.	ne&c de&st tu^o&s ca&ssa_ndra^ qvi_ tha^la^mo&s pe^ta&t 	X_^_X_^_^^_^X	1.0
Mea sors timetur, sola sum Danais metus.	me^a^ so&rs ti^me_tu&r so_la^ su&m da^na^i&s me^tu&s 	^^_^_X_^_^^_^X	0.97
Lamenta cessant? turba captiuae mea,	la&me_nta^ ce_ssa&nt tu_rba^ ca_pti&v[ae] me^a& 	X_^_X_^_X_^X	1.0
Ferite palmis pectora et planctus date	fe&ri_te^ pa_lmi&s pe_cto^ra& e&t pla&nctu&s da^te& 	X_^_X_^_X_^X	1.0
Et iusta Troiae facite. iamdudum sonet	e&t ju_sta^ tro_j[ae] fa^ci^te^ ja_mdu&du&m so^ne&t 	X_^_X^^^_X_^X	1.0
Fatalis Ide, iudicis diri domus.	fa&ta_li^s i_de& ju_di^ci&s di&ri_ do^mu&s 	X_^_X_^_X_^X	1.0
O longa Danais semper in portu mora,	o& lo_nga^ da^na^i&s se_mpe^r i&n po&rtu_ mo^ra& 	X_^^^X_^_X_^X	0.98
Seu petere bellum, petere seu patriam uolunt.	s[eu] pe^te^re^ be_llu&m pe^te^re^ s[eu] pa^tri^a&m vo^lu&nt 	X^^^_X^^^_^^_^X	1.0
Quae causa ratibus faciat et Danais moram,	qv[ae] c[au]sa^ ra^ti^bu&s fa^ci^a^t e&t da^na^i&s mo^ra&m 	X_^^^X^^^_^^_^X	1.0
Effare, reduces quis deus claudat uias.	e&ffa_re^ re^du^ce&s qvi&s de^u&s cl[au]da&t vi^a&s 	X_^^^X_^_X_^X	1.0
Pauet animus, artus horridus quassat tremor.	pa^ve^t a^ni^mu^s a_rtu&s ho_rri^du&s qva&ssa&t tre^mo&r 	^^^^^_X_^_X_^X	1.0
Maiora ueris monstra (uix capiunt fidem)	ma&jo_ra^ ve_ri&s mo_nstra^ vi&x ca^pi^u&nt fi^de&m 	X_^_X_^_^^_^X	1.0
Vidi ipse, uidi. summa iam Titan iuga	vi&di& i_pse^ vi_di& su_mma^ ja&m ti&ta&n ju^ga& 	X_^_X_^_X_^X	1.0
Stringebat ortu, uicerat noctem dies,	stri&nge_ba^t o_rtu& vi_ce^ra&t no&cte&m di^e&s 	X_^_X_^_X_^X	1.0
Cum subito caeco terra mugitu fremens	cu&m su^bi^to^ c[ae]co_ te_rra^ mu_gi_tu& fre^me&ns 	X^^^_X_^_X_^X	m
Concussa totos traxit ex imo sinus;	co&ncu_ssa^ to_to&s tra_xi^t e&x i&mo_ si^nu&s 	X_^_X_^_X_^X	1.0
Mouere siluae capita et excelsum nemus	mo&ve_re^ si_lv[ae] ca^pi^ta& e^t e_xce&lsu&m ne^mu&s 	X_^_X^^^_X_^X	1.0
Fragore uasto tonuit et lucus sacer;	fra&go_re^ va_sto& to^nu^i^t e&t lu&cu&s sa^ce&r 	X_^_X^^^_X_^X	1.0
Idaea ruptis saxa ceciderunt iugis.	i&d[ae]a^ ru_pti&s sa_xa^ ce^ci^de&ru&nt ju^gi&s 	X_^_X_^^^X_^X	1.0
Nec terra solum tremuit: et pontus suum	ne&c te_rra^ so_lu&m tre^mu^i^t e&t po&ntu&s su^u&m 	X_^_X^^^_X_^X	0.63
Adesse Achillem sensit ac strauit uada.	a&de_sse& a^chi_lle&m se_nsi^t a&c str[au]i&t va^da& 	X_^_X_^_X_^X	1.0
Tum scissa uallis aperit immensos specus	tu&m sci_ssa^ va_lli&s a^pe^ri^t i_mme&nso&s spe^cu&s 	X_^_X^^^_X_^X	1.0
Et hiatus Erebi peruium ad superos iter	e^t hi^a_tu^s e^re^bi& pe_rvi^u&m a&d su^pe^ro_s i^te&r 	^^_^^^X_^_^^_^X	1.0
Tellure fracta praebet ac tumulum leuat.	te&llu_re^ fra_cta& pr[ae]be^t a&c tu^mu^lu&m le^va&t 	X_^_X_^_^^_^X	1.0
Emicuit ingens umbra Thessalici ducis,	e&mi^cu^i^t i_nge&ns u_mbra^ the_ssa^li^ci_ du^ci&s 	X^^^_X_^_^^_^X	0.95
Threicia qualis arma proludens tuis	thre&i^ci^a^ qva_li&s a_rma^ pro_lu&de_ns tu^i&s 	X^^^_X_^_X_^X	1.0
Iam, Troia, fatis strauit aut Neptunium	ja&m tro_ja^ fa_ti&s str[au]i^t [au]t ne&ptu_ni^u&m 	X_^_X_^_X_^X	0.68
Cana nitentem perculit iuuenem coma,	ca&na_ ni^te_nte&m pe_rcu^li&t ju^ve^ne&m co^ma& 	X_^_X_^_^^_^X	0.44
Aut cum inter acies Marte uiolento furens	[au]t cu&m i_nte^r a^ci^e&s ma_rte^ vi^o^le&nto_ fu^re&ns 	X_^^^X_^^^X_^X	1.0
Corporibus amnes clusit et quaerens iter	co&rpo^ri^bu^s a_mne&s clu_si^t e&t qv[ae]re&ns i^te&r 	X^^^_X_^_X_^X	1.0
Tardus cruento Xanthus errauit uado,	ta&rdu&s cru^e_nto& xa_nthu^s e_rr[au]i&t va^do& 	X_^_X_^_X_^X	0.87
Aut cum superbo uictor in curru stetit	[au]t cu&m su^pe_rbo& vi_cto^r i&n cu&rru& ste^ti&t 	X_^_X_^_X_^X	1.0
Egitque habenas Hectorem et Troiam trahens.	e&gi_tqve& ha^be_na&s he_cto^re&m e&t tro&ja&m tra^he&ns 	X_^_X_^_X_^X	1.0
Impleuit omne litus irati sonus:	i&mpl[eu]i^t o_mne& li_tu^s i_ra&ti_ so^nu&s 	X_^_X_^_X_^X	1.0
'Ite, ite, inertes, debitos manibus meis	i&te& i_te& i^ne_rte&s de_bi^to&s ma^ni^bu&s me^i&s 	X_^_X_^_^^_^X	0.66
Auferte honores, soluite ingratas rates	[au]fe_rte& ho^no_re&s so_lvi^te& i_ngra&ta&s ra^te&s 	X_^_X_^_X_^X	1.0
Per nostra ituri maria. non paruo luit	pe&r no_stra& i^tu_ri& ma^ri^a^ no&n pa&rvo_ lu^i&t 	X_^_X^^^_X_^X	1.0
Iras Achillis Graecia et magno luet:	i&ra_s a^chi_lli&s gr[ae]ci^a& e&t ma&gno_ lu^e&t 	X_^_X_^_X_^X	1.0
Desponsa nostris cineribus Polyxene	de&spo_nsa^ no_stri&s ci^ne^ri^bu_s po&ly_xe^ne& 	X_^_X^^^_X_^X	1.0
Pyrrhi manu mactetur et tumulum riget.'	py&rrhi_ ma^nu_ ma&cte_tu^r e&t tu^mu^lu&m ri^ge&t 	X_^_X_^_^^_^X	1.0
Haec fatus † alta nocte diuisit † diem	h[ae]c fa_tu^s a_lta& no_cte^ di_vi&si&t di^e&m 	X_^_X_^_X_^X	1.0
Repetensque Ditem mersus ingentem specum	re^pe^te_nsqve^ di_te&m me_rsu^s i_nge&nte&m spe^cu&m 	^^_^_X_^_X_^X	1.0
Coeunte terra iunxit. immoti iacent	co^e^u_nte^ te_rra& ju_nxi^t i_mmo&ti_ ja^ce&nt 	^^_^_X_^_X_^X	1.0
Tranquilla pelagi, uentus abiecit minas	tra&nqvi_lla^ pe^la^gi& ve_ntu^s a_bje&ci&t mi^na&s 	X_^^^X_^_X_^X	1.0
Placidumque fluctu murmurat leni mare,	pla^ci^du_mqve^ flu_ctu& mu_rmu^ra&t le&ni_ ma^re& 	^^_^_X_^_X_^X	1.0
Tritonum ab alto cecinit hymenaeum chorus.	tri&to_nu&m a^b a_lto& ce^ci^ni^t hy^me^n[ae]u&m cho^ru&s 	X_^_X^^^^^X_^X	1.0
Cum laeta pelago uela rediturus dares,	cu&m l[ae]ta^ pe^la^go& ve_la^ re^di^tu&ru&s da^re&s 	X_^^^X_^^^X_^X	1.0
Excidit Achilles, cuius unius manu	e&xci^di^t a^chi_lle&s cu_ju^s u_ni&u&s ma^nu& 	X^^^_X_^_X_^X	1.0
Impulsa Troia, quidquid adiecit morae	i&mpu_lsa^ tro_ja& qvi_dqvi^d a_dje&ci&t mo^r[ae]	X_^_X_^_X_^X	m
Illo remoto, dubia quo caderet stetit?	i&llo_ re^mo_to& du^bi^a^ qvo_ ca^de^re&t ste^ti&t 	X_^_X^^^_^^_^X	1.0
Velis licet quod petitur ac properes dare,	ve&li&s li^ce&t qvo&d pe^ti^tu^r a&c pro^pe^re&s da^re& 	X_^_X^^^_^^_^X	1.0
Sero es daturus: iam suum cuncti duces	se&ro& e&s da^tu_ru&s ja&m su^u&m cu&ncti_ du^ce&s 	X_^_X_^_X_^X	1.0
Tulere pretium. quae minor merces potest	tu&le_re^ pre^ti^u&m qv[ae] mi^no&r me&rce&s po^te&st 	X_^^^X_^_X_^X	1.0
Tantae dari uirtutis? an meruit parum	ta&nt[ae] da^ri_ vi&rtu_ti^s a&n me^ru^i&t pa^ru&m 	X_^_X_^_^^_^X	1.0
Qui, fugere bellum iussus et longa sedens	qvi& fu^ge^re^ be_llu&m ju_ssu^s e&t lo&nga_ se^de&ns 	X^^^_X_^_X_^X	0.29
Aeuum senecta ducere ac Pylii senis	[ae]vu&m se^ne_cta& du_ce^re& a&c py^li^i_ se^ni&s 	X_^_X_^_^^_^X	0.83
Transcendere annos, exuit matris dolos	tra&nsce_nde^re& a_nno&s e_xu^i&t ma&tri&s do^lo&s 	X_^_X_^_X_^X	1.0
Falsasque uestes, fassus est armis uirum?	fa&lsa_sqve^ ve_ste&s fa_ssu^s e&st a&rmi&s vi^ru&m 	X_^_X_^_X_^X	1.0
Inhospitali Telephus regno impotens,	i&nho_spi^ta_li& te_le^phu&s re&gno& i_mpo^te&ns 	X_^_X_^_X_^X	1.0
Dum Mysiae ferocis introitus negat,	du&m my_si^[ae] fe&ro_ci^s i_ntro^i^tu&s ne^ga&t 	X_^_X_^_^^_^X	1.0
Rudem cruore regio dextram imbuit	ru&de&m cru^o_re& re_gi^o_ de_xtra&m i_mbu^i&t 	X_^_X_^_X_^X	m
Fortemque eandem sensit et mitem manum.	fo&rte_mqve& e^a_nde&m se_nsi^t e&t mi&te&m ma^nu&m 	X_^_X_^_X_^X	1.0
Cecidere Thebae, uidit Eetion capi	ce^ci^de_re^ the_b[ae] vi_di^t e_e^ti^o&n ca^pi&	^^_^_X_^_^^_^X	m
Sua regna uictus; clade subuersa est pari	su^a^ re_gna^ vi_ctu&s cla_de^ su_bve&rsa& e&st pa^ri& 	^^_^_X_^_X_^X	1.0
Apposita celso parua Lyrnesos iugo,	a&ppo^si^ta^ ce_lso& pa_rva^ ly_rne&so_s ju^go& 	X^^^_X_^_X_^X	1.0
Captaque tellus nobilis Briseide	ca_pta_que^ te_llu&s no_bi^li&s bri&se_i^de& 	X_^_X_^_X_^X	m
Et causa litis regibus Chryse iacet	e&t c[au]sa^ li_ti&s re_gi^bu&s chry&se_ ja^ce&t 	X_^_X_^_X_^X	1.0
Et nota fama Tenedos et quae pascuo	e&t no_ta^ fa_ma& te^ne^do^s e&t qv[ae] pa_scu^o& 	X_^_X^^^_X_^X	0.95
Fecunda pingui Thracios nutrit greges	fe&cu_nda^ pi_ngvi& thra_ci^o_s nu&tri&t gre^ge&s 	X_^_X_^_X_^X	1.0
Scyros fretumque Lesbos Aegaeum secans	scy&ro_s fre^tu_mqve& le_sbo^s [ae]g[ae]u&m se^ca&ns 	X_^_X_^_X_^X	0.96
Et cara Phoebo Cilla; quid quas alluit	e&t ca_ra^ ph[oe]bo& ci_lla^ qvi&d qva&s a_llu^i&t 	X_^_X_^_X_^X	1.0
Vernis Caycus gurgitem attollens aquis?	ve&rni&s ca^y_cu&s gu_rgi^te&m a_tto&lle&ns a^qvi&s 	X_^_X_^_X_^X	1.0
Haec tanta clades gentium ac tantus pauor,	h[ae]c ta_nta^ cla_de&s ge_nti^u&m a&c ta&ntu&s pa^vo&r 	X_^_X_^_X_^X	1.0
Sparsae tot urbes turbinis uasti modo,	spa&rs[ae] to^t u_rbe&s tu_rbi^ni&s va&sti_ mo^do& 	X_^_X_^_X_^X	1.0
Alterius esset gloria ac summum decus:	a&lte^ri^u^s e_sse&t glo_ri^a& a&c su&mmu&m de^cu&s 	X^^^_X_^_X_^X	1.0
Iter est Achillis; sic meus uenit pater	i^te^r e&st a^chi_lli&s si&c me^u&s ve&ni&t pa^te&r 	^^_^_X_^_X_^X	1.0
Et tanta gessit bella, dum bellum parat.	e&t ta_nta^ ge_ssi&t be_lla^ du&m be&llu&m pa^ra&t 	X_^_X_^_X_^X	1.0
Vt alia sileam merita, non unus satis	u&t a^li^a^ si^le^a&m me^ri^ta^ no_n u&nu&s sa^ti&s 	X^^^^^X^^^_X_^X	1.0
Hector fuisset? Ilium uicit pater,	he&cto&r fu^i_sse&t i_li^u&m vi&ci&t pa^te&r 	X_^_X_^_X_^X	1.0
Vos diruistis. inclitas laudes iuuat	vo&s di_ru^i_sti&s i_ncli^ta&s l[au]de&s ju^va&t 	X_^_X_^_X_^X	1.0
Et clara magni facta genitoris sequi:	e&t cla_ra^ ma_gni& fa_cta^ ge^ni^to&ri&s se^qvi& 	X_^_X_^^^X_^X	1.0
Iacuit peremptus Hector ante oculos patris	ja^cu^i&t pe^re_mptu&s he_cto^r a_nte& o^cu^lo&s pa^tri&s 	^^_^_X_^_^^_^X	0.55
Patruique Memnon, cuius ob luctum parens	pa^tru^i_qve^ me_mno&n cu_ju^s o&b lu_ctu&m pa^re&ns	^^_^_X_^_X_^X	m
Pallente maestum protulit uultu diem;	pa&lle_nte^ m[ae]stu&m pro_tu^li&t vu&ltu_ di^e&m 	X_^_X_^_X_^X	1.0
Suique uictor operis exemplum horruit	su&i_qve^ vi_cto&r o^pe^ri^s e_xe&mplu&m ho_rru^i&t 	X_^_X^^^_X_^X	1.0
Didicitque Achilles et dea natos mori.	di^di^ci_tqve& a^chi_lle&s e&t de^a_ na&to&s mo^ri& 	^^_^_X_^_X_^X	1.0
Tum saeua Amazon ultimus cecidit metus. -	tu&m s[ae]va& a^ma_zo&n u_lti^mu&s ce^ci^di&t me^tu&s 	X_^_X_^_^^_^X	0.97
Debes Achilli, merita si digne aestimas,	de&be_s a^chi_lli& me^ri^ta^ si_ di&gne& [ae]sti^ma&s 	X_^_X^^^_X_^X	1.0
Et si ex Mycenis uirginem atque Argis petat.	e&t si& e&x my^ce_ni&s vi_rgi^ne&m a_tqve& a&rgi&s pe^ta&t 	X_^_X_^_X_^X	1.0
Dubitatur etiam? placida nunc subito probas	du^bi^ta_tu^r e^ti^a&m pla^ci^da^ nu&nc su^bi^to& pro^ba&s	^^_^^^X^^^_^^_^X	m
Priamique natam Pelei gnato ferum	pri^a^mi_que^ na&ta&m pe_le^i& gna&to_ fe^ru&m 	^^_^_X_^_X_^X	m
Mactare credis? at tuam gnatam parens	ma&cta_re^ cre_di&s a&t tu^a&m gna&ta_m pa^re&ns 	X_^_X_^_X_^X	0.97
Helenae immolasti: solita iam et facta expeto.	he^le^n[ae] i_mmo^la_sti& so^li^ta^ ja&m e&t fa&cta& e_xpe^to& 	^^_^_X^^^_X_^X	1.0
Iuuenile uitium est regere non posse impetum;	ju^ve^ni_le^ vi^ti^u&m e&st re^ge^re^ no&n po&sse& i_mpe^tu&m 	^^_^^^X^^^_X_^X	1.0
Aetatis alios feruor hic primus rapit,	[ae]ta_ti^s a^li^o&s fe_rvo^r hi&c pri&mu&s ra^pi&t 	X_^^^X_^_X_^X	1.0
Pyrrhum paternus. spiritus quondam truces	py&rrhu_m pa^te_rnu&s spi_ri^tu&s qvo&nda&m tru^ce&s 	X_^_X_^_X_^X	1.0
Minasque tumidi lentus Aeacidae tuli:	mi&na_sqve^ tu^mi^di& le_ntu^s [ae]a^ci^d[ae] tu^li& 	X_^^^X_^_^^_^X	1.0
Quo plura possis, plura patienter feras.	qvo& plu_ra^ po_ssi&s plu_ra^ pa^ti^e&nte_r fe^ra&s 	X_^_X_^^^X_^X	1.0
Quid caede dira nobiles clari ducis	qvi&d c[ae]de^ di_ra& no_bi^le&s cla&ri_ du^ci&s 	X_^_X_^_X_^X	0.95
Aspergis umbras? noscere hoc primum decet,	a&spe_rgi^s u_mbra&s no_sce^re& ho&c pri&mu&m de^ce&t 	X_^_X_^_X_^X	0.96
Quid facere uictor debeat, uictus pati.	qvi&d fa^ce^re^ vi_cto&r de_be^a&t vi&ctu&s pa^ti& 	X^^^_X_^_X_^X	1.0
Violenta nemo imperia continuit diu,	vi^o^le_nta^ ne_mo& i&mpe^ri^a^ co_nti^nu^i&t di^u& 	^^_^_X^^^_^^_^X	1.0
Moderata durant; quoque Fortuna altius	mo^de^ra_ta^ du_ra&nt qvo_qve^ fo_rtu&na& a_lti^u&s 	^^_^_X_^_X_^X	0.07
Euexit ac leuauit humanas opes,	[eu]e_xi^t a&c le&v[au]i^t hu_ma&na_s o^pe&s 	X_^_X_^_X_^X	1.0
Hoc se magis supprimere felicem decet	ho&c se_ ma^gi&s su&ppri^me^re^ fe_li&ce&m de^ce&t 	X_^_X^^^_X_^X	1.0
Variosque casus tremere metuentem deos	va^ri^o_sqve^ ca_su&s tre^me^re^ me^tu^e&nte&m de^o&s 	^^_^_X^^^^^X_^X	1.0
Nimium fauentes. magna momento obrui	ni^mi^u&m fa^ue_nte&s. ma_gna^ mo_me_nto& o_bru^i& 	^^_^_X_^_X_^X	m
Vincendo didici. Troia nos tumidos facit	vi_nce_ndo^ di^di^ci&. tro_ia^ no&s tu^mi^do&s fa^ci&t 	X_^^^X_^_^^_^X	m
Nimium ac feroces? stamus hoc Danai loco,	ni^mi^u&m a&c fe^ro_ce&s sta_mu^s ho&c da^na^i_ lo^co& 	^^_^_X_^_^^_^X	1.0
Vnde illa cecidit. fateor, aliquando impotens	u&nde& i_lla^ ce^ci^di&t fa^te^o^r a^li^qva&ndo& i_mpo^te&ns 	X_^^^X^^^^^X_^X	0.97
Regno ac superbus altius memet tuli;	re&gno& a&c su^pe_rbu&s a_lti^u&s me&me&t tu^li& 	X_^_X_^_X_^X	1.0
Sed fregit illos spiritus haec quae dare	se&d fre_gi^t i_llo&s spi_ri^tu&s h[ae]c qu[ae] da^re& 	X_^_X_^_X_^X	m
Potuisset aliis causa, Fortunae fauor.	po^tu^i_sse^t a^li^i&s c[au]sa^ fo_rtu&n[ae] fa^vo&r 	^^_^^^X_^_X_^X	1.0
Tu me superbum, Priame? tu timidum facis.	tu& me_ su^pe_rbu&m pri^a^me^ tu_ ti^mi^du&m fa^ci&s 	X_^_X^^^_^^_^X	1.0
Ego esse quicquam sceptra nisi uano putem	e&go& e_sse^ qvi_cqva&m sce_ptra^ ni^si^ va&no_ pu^te&m 	X_^_X_^^^X_^X	0.97
Fulgore tectum nomen et falso comam	fu&lgo_re^ te_ctu&m no_me^n e&t fa&lso_ co^ma&m 	X_^_X_^_X_^X	1.0
Vinclo decentem? casus haec rapiet leuis,	vi&nclo_ de^ce_nte&m ca_su^s h[ae]c ra^pi^e&t le^vi&s 	X_^_X_^_^^_^X	m
Nec mille forsan ratibus aut annis decem:	ne&c mi_lle^ fo_rsa&n ra^ti^bu^s [au]t a&nni&s de^ce&m 	X_^_X^^^_X_^X	1.0
Non omnibus Fortuna tam lenta imminet.	no&n o_mni^bu&s fo&rtu_na^ ta&m le&nta& i_mmi^ne&t 	X_^_X_^_X_^X	1.0
Equidem fatebor (pace dixisse hoc tua,	e^qvi^de&m fa^te_bo&r pa_ce^ di_xi&sse& ho&c tu^a& 	^^_^_X_^_X_^X	1.0
Argiua tellus, liceat) affligi Phrygas	a&rgi_va^ te_llu&s li^ce^a^t a_ffli&gi& phry^ga&s 	X_^_X^^^_X_^X	1.0
Vincique uolui: ruere et aequari solo	vi&nci_qve^ vo^lu^i& ru^e^re& e^t [ae]qva&ri_ so^lo&	X_^^^X^^^_X_^X	m
Vtinam arcuissem; sed regi frenis nequit	u^ti^na&m a_rcu^i_sse&m se&d re^gi& fre&ni&s ne^qvi&t 	^^_^_X_^_X_^X	0.02
Et ira et ardens ensis et uictoria	e&t i_ra& e^t a_rde&ns e_nsi^s e&t vi&cto_ri^a& 	X_^_X_^_X_^X	0.95
Commissa nocti. quidquid indignum aut ferum	co&mmi_ssa^ no_cti& qvi_dqvi^d i_ndi&gnu&m [au]t fe^ru&m 	X_^_X_^_X_^X	1.0
Cuiquam uideri potuit, hoc fecit dolor	cu&jqva&m vi^de_ri& po^tu^i^t ho&c fe&ci&t do^lo&r 	X_^_X^^^_X_^X	1.0
Tenebraeque, per quas ipse se irritat furor,	te^ne^br[ae]qve^ pe&r qva&s i_pse^ se& i_rri&ta&t fu^ro&r 	^^_^_X_^_X_^X	0.38
Gladiusque felix, cuius infecti semel	gla^di^u_sqve^ fe_li&x cu_ju^s i_nfe&cti_ se^me&l 	^^_^_X_^_X_^X	1.0
Vecors libido est. quidquid euersae potest	ve&co&rs li^bi_do& e&st qvi_dqvi^d [eu]e&rs[ae] po^te&st 	X_^_X_^_X_^X	1.0
Superesse Troiae, maneat: exactum satis	su^pe^re_sse^ tro_j[ae] ma^ne^a^t e_xa&ctu&m sa^ti&s 	^^_^_X^^^_X_^X	1.0
Poenarum et ultra est. regia ut uirgo occidat	p[oe]na_ru&m e^t u_ltra& e&st re_gi^a& u&t vi&rgo& o_cci^da&t 	X_^_X_^_X_^X	1.0
Tumuloque donum detur et cineres riget	tu^mu^lo_qve^ do_nu&m de_tu^r e&t ci^ne^re&s ri^ge&t 	^^_^_X_^_^^_^X	1.0
Et facinus atrox caedis ut thalamos uocent,	e&t fa^ci^nu^s a_tro&x c[ae]di^s u&t tha^la^mo&s vo^ce&nt 	X^^^_X_^_^^_^X	0.1
Non patiar. in me culpa cunctorum redit:	no&n pa^ti^a^r i&n me& cu_lpa^ cu_ncto&ru&m re^di&t 	X^^^_X_^_X_^X	1.0
Qui non uetat peccare, cum possit, iubet.	qvi& no&n ve^ta&t pe&cca_re^ cu&m po&ssi&t ju^be&t 	X_^_X_^_X_^X	1.0
Nullumne Achillis praemium manes ferent?	nu&llu_mne& a^chi_lli&s pr[ae]mi^u&m ma&ne&s fe^re&nt 	X_^_X_^_X_^X	1.0
Ferent, et illum laudibus cuncti canent	fe&re&nt e^t i_llu&m l[au]di^bu&s cu&ncti_ ca^ne&nt 	X_^_X_^_X_^X	1.0
Magnumque terrae nomen ignotae audient.	ma&gnu_mqve^ te_rr[ae] no_me^n i_gno&t[ae] [au]di^e&nt 	X_^_X_^_X_^X	1.0
Quod si leuatur sanguine infuso cinis,	qvo&d si_ le^va_tu&r sa_ngvi^ne& i_nfu&so_ ci^ni&s 	X_^_X_^_X_^X	0.97
Opima Phrygii colla caedantur greges	o&pi_ma^ phry^gi^i& co_lla^ c[ae]da&ntu&r gre^ge&s 	X_^^^X_^_X_^X	1.0
Fluatque nulli flebilis matri cruor.	flu&a_tqve^ nu_lli& fle_bi^li&s ma&tri& cru^o&r 	X_^_X_^_X_^X	1.0
Quis iste mos est? quando in inferias homo est	qvi&s i_ste^ mo_s e&st qva_ndo& i^n i_nfe^ri^a_s ho^mo& e&st 	X_^_X_^_^^_^X	1.0
Impensus hominis? detrahe inuidiam tuo	i&mpe_nsu^s ho^mi^ni&s de_tra^he& i_nvi^di^a&m tu^o& 	X_^^^X_^_^^_^X	1.0
Odiumque patri, quem coli poena iubes.	o^di^u_mqve^ pa_tri& qve&m co^li_ p[oe]na_ ju^be&s 	^^_^_X_^_X_^X	0.46
O tumide, rerum dum secundarum status	o& tu^mi^de^ re_ru&m du&m se^cu_nda&ru_m sta^tu&s 	X^^^_X_^_X_^X	1.0
Extollit animos, timide, cum increpuit metus,	e_xto_lli^t a^ni^mo&s, ti^mi^de^, cu&m i_ncre^pu^i&t me^tu&s, 	X_^^^X^^^_^^_^X	m
Regum tyranne! iamne flammatum geris	re&gu&m ty^ra_nne& ja_mne^ fla_mma&tu&m ge^ri&s 	X_^_X_^_X_^X	1.0
Amore subito pectus ac ueneris nouae	a&mo_re^ su^bi^to& pe_ctu^s a&c ve^ne^ri&s no^v[ae] 	X_^^^X_^_^^_^X	0.97
Solusne totiens spolia de nobis feres?	so&lu_sne^ to^ti^e&ns spo^li^a^ de_ no&bi&s fe^re&s 	X_^^^X^^^_X_^X	1.0
Hac dextra Achilli uictimam reddam suam.	ha&c de_xtra& a^chi_lli& vi_cti^ma&m re&dda&m su^a&m 	X_^_X_^_X_^X	1.0
Quam si negas retinesque, maiorem dabo	qva&m si_ ne^ga&s re^ti^ne_sqve^ ma_jo&re&m da^bo& 	X_^_^^_^_X_^X	1.0
Dignamque quam det Pyrrhus; et nimium diu	di&gna_mqve^ qva&m de&t py_rrhu^s e&t ni^mi^u&m di^u& 	X_^_X_^_^^_^X	1.0
A caede nostra regia cessat manus	a& c[ae]de^ no_stra& re_gi^a_ ce&ssa&t ma^nu&s 	X_^_X_^_X_^X	1.0
Paremque poscit Priamus. Haud equidem nego	pa&re_mqve^ po_sci&t pri^a^mu^s h[au]d e^qvi^de&m ne^go& 	X_^_X^^^_^^_^X	1.0
Hoc esse Pyrrhi maximum in bello decus,	ho&c e_sse^ py_rrhi& ma_xi^mu&m i&n be&llo_ de^cu&s 	X_^_X_^_X_^X	1.0
Saeuo peremptus ense quod Priamus iacet,	s[ae]vo_ pe^re_mptu&s e_nse^ qvo&d pri^a^mu&s ja^ce&t 	X_^_X_^_^^_^X	1.0
Supplex paternus. Supplices nostri patris	su&pple&x pa^te_rnu&s su_ppli^ce&s no&stri_ pa^tri&s 	X_^_X_^_X_^X	0.55
Hostesque eosdem nouimus. Priamus tamen	ho&ste_sqve& e^o_sde&m no_vi^mu&s pri^a^mu&s ta^me&n 	X_^_X_^_^^_^X	1.0
Praesens rogauit; tu, graui pauidus metu	pr[ae]se&ns ro^g[au]i&t tu& gra^vi_ pa^vi^du&s me^tu& 	X_^_X_^_^^_^X	1.0
Nec ad rogandum fortis, Aiaci preces	ne&c a&d ro^ga_ndu&m fo_rti^s a_ja&ci& pre^ce&s 	X_^_X_^_X_^X	1.0
Ithacoque mandas clausus atque hostem tremens.	i^tha^co_qve^ ma_nda&s cl[au]su^s a_tqve& ho&ste&m tre^me&ns	^^_^_X_^_X_^X	m
At non timebat tunc tuus, fateor, parens,	a&t no&n ti^me_ba&t tu&nc tu^u&s fa^te^o&r pa^re&ns 	X_^_X_^_^^_^X	0.97
Interque caedes Graeciae atque ustas rates	i&nte_rqve^ c[ae]de&s gr[ae]ci^[ae] a_tqve& u&sta&s ra^te&s 	X_^_X_^_X_^X	1.0
Segnis iacebat belli et armorum immemor,	se&gni&s ja^ce_ba&t be_lli& e^t a_rmo&ru&m i_mme^mo&r 	X_^_X_^_X_^X	1.0
Leui canoram uerberans plectro chelyn.	le&vi_ ca^no_ra&m ve_rbe^ra_ns ple&ctro_ che^ly&n 	X_^_X_^_X_^X	1.0
Tunc magnus Hector, arma contemnens tua,	tu&nc ma_gnu^s he_cto&r a_rma^ co_nte&mne_ns tu^a& 	X_^_X_^_X_^X	1.0
Cantus Achillis timuit, et tanto in metu	ca&ntu_s a^chi_lli&s ti^mu^i^t e&t ta&nto& i&n me^tu& 	X_^_X^^^_X_^X	1.0
Naualibus pax alta Thessalicis fuit.	n[au]a_li^bu&s pa&x a_lta^ the_ssa^li^ci&s fu^i&t 	X_^_X_^_^^_^X	1.0
Nempe isdem in istis Thessalis naualibus	ne&mpe& i_sde&m i^n i_sti&s the_ssa^li&s n[au]a_li^bu&s 	X_^_X_^_X_^X	1.0
Pax alta rursus Hectoris patri fuit.	pa&x a_lta^ ru_rsu&s he_cto^ri&s pa&tri_ fu^i&t 	X_^_X_^_X_^X	1.0
Est regis alti spiritum regi dare.	e&st re_gi^s a_lti& spi_ri^tu&m re&gi_ da^re& 	X_^_X_^_X_^X	0.99
Cur dextra regi spiritum eripuit tua?	cu&r de_xtra^ re_gi& spi_ri^tu&m e_ri^pu^i&t tu^a& 	X_^_X_^_^^_^X	0.98
Mortem misericors saepe pro uita dabit.	mo&rte&m mi^se^ri^co&rs s[ae]pe^ pro_ vi&ta_ da^bi&t 	X_^^^X_^_X_^X	1.0
Et nunc misericors uirginem busto petis?	e&t nu&nc mi^se^ri^co&rs vi_rgi^ne&m bu&sto_ pe^ti&s 	X_^^^X_^_X_^X	1.0
Iamne immolari uirgines credis nefas?	ja&mne& i_mmo^la_ri& vi_rgi^ne&s cre&di&s ne^fa&s 	X_^_X_^_X_^X	1.0
Praeferre patriam liberis regem decet.	pr[ae]fe_rre^ pa^tri^a&m li_be^ri&s re&ge&m de^ce&t 	X_^^^X_^_X_^X	1.0
Lex nulla capto parcit aut poenam impedit.	le&x nu_lla^ ca_pto& pa_rci^t [au]t p[oe]na&m i_mpe^di&t 	X_^_X_^_X_^X	1.0
Quod non uetat lex, hoc uetat fieri pudor.	qvo&d no&n ve^ta&t le&x ho&c ve^ta&t fi^e^ri_ pu^do&r 	X_^_X_^_^^_^X	1.0
Quodcumque libuit facere uictori licet.	qvo&dcu_mqve^ li^bu^i&t fa^ce^re^ vi_cto&ri_ li^ce&t 	X_^^^X^^^_X_^X	1.0
Minimum decet libere cui multum licet.	mi^ni^mu&m de^ce&t li&be_re^ cu_j mu&ltu&m li^ce&t 	^^_^_X_^_X_^X	1.0
His ista iactas, quos decem annorum graui	hi&s i_sta^ ja_cta&s qvo&s de^ce&m a_nno&ru&m gra^vi& 	X_^_X_^_X_^X	1.0
Regno subactos Pyrrhus exsoluet iugo?	re&gno_ su^ba_cto&s py_rrhu^s e_xso&lve&t ju^go& 	X_^_X_^_X_^X	1.0
Hos Scyros animos? Scelere quae fratrum caret.	ho&s scy_ro^s a^ni^mo&s sce^le^re^ qv[ae] fra&tru&m ca^re&t 	X_^^^X^^^_X_^X	1.0
Inclusa fluctu - Nempe cognati maris:	i&nclu_sa^ flu_ctu& ne_mpe^ co_gna&ti_ ma^ri&s 	X_^_X_^_X_^X	1.0
Atrei et Thyestae nobilem noui domum.	a^tre^i& e&t thy^e_st[ae] no_bi^le&m no&ui_ do^mu&m. 	^^_^_X_^_X_^X	m
Ex uirginis concepte furtiuo stupro	e&x vi_rgi^ni&s co&nce_pte^ fu_rti&vo& stu^pro& 	X_^_X_^_X_^X	1.0
Et ex Achille nate, sed nondum uiro -	e&t e&x a^chi_lle& na_te^ se&d no&ndu&m vi^ro& 	X_^_X_^_X_^X	1.0
Illo ex Achille, genere qui mundum suo,	i&llo& e&x a^chi_lle& ge^ne^re^ qvi_ mu&ndu&m su^o& 	X_^_X^^^_X_^X	1.0
Sparsus per omne caelitum regnum, tenet:	spa&rsu&s pe^r o_mne& c[ae]li^tu_m re&gnu&m te^ne&t 	X_^_X_^_X_^X	1.0
Thetide aequor, umbras Aeaco, caelum Ioue.	the^ti^de& [ae]qvo^r u_mbra&s [ae]a^co_ c[ae]lu&m jo^ve& 	^^_^_X_^_X_^X	1.0
Illo ex Achille, qui manu Paridis iacet.	i&llo& e&x a^chi_lle& qvi_ ma^nu_ pa^ri^di&s ja^ce&t 	X_^_X_^_^^_^X	1.0
Quem nec deorum comminus quisquam petit.	qve&m ne&c de^o_ru&m co_mmi^nu&s qvi&sqva&m pe^ti&t 	X_^_X_^_X_^X	1.0
Compescere equidem uerba et audacem malo	co&mpe_sce^re& e^qvi^de&m ve_rba& e^t [au]da&ce&m ma^lo& 	X_^^^X_^_X_^X	0.5
Poteram domare; sed meus captis quoque	po^te^ra&m do^ma_re& se&d me^u&s ca&pti&s qvo^qve& 	^^_^_X_^_X_^X	0.93
Scit parcere ensis. potius interpres deum	sci&t pa_rce^re& e_nsi&s po^ti^u^s i_nte&rpre&s de^u&m 	X_^_X^^^_X_^X	1.0
Calchas uocetur: fata si poscent, dabo.	ca&lcha&s vo^ce_tu&r fa_ta^ si_ po&sce&nt da^bo& 	X_^_X_^_X_^X	1.0
Tu, qui Pelasgae uincla soluisti rati	tu& qvi_ pe^la_sg[ae] vi_ncla^ so_lvi&sti_ ra^ti& 	X_^_X_^_X_^X	1.0
Morasque bellis, arte qui reseras polum,	mo&ra_sqve^ be_lli&s a_rte^ qvi_ re^se^ra&s po^lu&m 	X_^_X_^_^^_^X	0.97
Cui uiscerum secreta, cui mundi fragor	cu&j vi_sce^ru_m se&cre_ta^ cu_j mu&ndi& fra^go&r 	X_^_X_^_X_^X	1.0
Et stella longa semitam flamma trahens	e&t ste_lla^ lo_nga& se_mi^ta&m fla&mma_ tra^he&ns 	X_^_X_^_X_^X	1.0
Dant signa fati, cuius ingenti mihi	da&nt si_gna^ fa_ti& cu_ju^s i_nge&nti_ mi^hi& 	X_^_X_^_X_^X	1.0
Mercede constant ora: quid iubeat deus	me&rce_de^ co_nsta&nt o_ra^ qvi&d ju^be^a&t de^u&s 	X_^_X_^_^^_^X	1.0
Effare, Calchas, nosque consilio rege.	e&ffa_re^ ca_lcha&s no_sqve^ co_nsi^li^o_ re^ge& 	X_^_X_^_^^_^X	0.07
Dant fata Danais quo solent pretio uiam:	da&nt fa_ta^ da^na^i&s qvo_ so^le&nt pre^ti^o_ vi^a&m 	X_^^^X_^_^^_^X	1.0
Mactanda uirgo est Thessali busto ducis;	ma&cta_nda^ vi_rgo& e&st the_ssa^li_ bu&sto_ du^ci&s 	X_^_X_^_X_^X	0.95
Sed quo iugari Thessalae cultu solent	se&d qvo_ ju^ga_ri& the_ssa^l[ae] cu&ltu_ so^le&nt 	X_^_X_^_X_^X	1.0
Ionidesue uel Mycenaeae nurus,	i^o_ni^de_sue&& ue&l my^ce_n[ae][ae] nu^ru&s, 	X_^_X_^_X_^X	m
Pyrrhus parenti coniugem tradat suo:	py&rrhu&s pa^re_nti& co_nju^ge&m tra&da&t su^o& 	X_^_X_^_X_^X	1.0
Sic rite dabitur. Non tamen nostras tenet	si&c ri_te^ da^bi^tu&r no&n ta^me&n no&stra&s te^ne&t 	X_^^^X_^_X_^X	1.0
Haec una puppes causa: nobilior tuo,	h[ae]c u_na^ pu_ppe&s c[au]sa^ no_bi^li^o&r tu^o& 	X_^_X_^_^^_^X	1.0
Polyxene, cruore debetur cruor.	po&ly_xe^ne_ cru&o_re^ de_be&tu&r cru^o&r 	X_^_X_^_X_^X	1.0
Quem fata quaerunt, turre de summa cadat	qve&m fa_ta^ qv[ae]ru&nt tu_rre^ de_ su&mma_ ca^da&t 	X_^_X_^_X_^X	1.0
Priami nepos Hectoreus et letum oppetat.	pri^a^mi_ ne^po&s he_cto^re^u^s e&t le_tu&m o_ppe^ta&t. 	^^_^_X^^^_X_^X	m
Tum mille uelis impleat classis freta.	tu&m mi_lle^ ve_li&s i_mple^a&t cla&ssi&s fre^ta& 	X_^_X_^_X_^X	0.51
Quid, maesta Phrygiae turba, laceratis comas	qvi&d m[ae]sta^ phry^gi^[ae] tu_rba^ la^ce^ra&ti&s co^ma&s 	X_^^^X_^^^X_^X	1.0
Miserumque tunsae pectus effuso genas	mi^se^ru_mqve^ tu_ns[ae] pe_ctu^s e_ffu&so_ ge^na&s 	^^_^_X_^_X_^X	1.0
Fletu rigatis? leuia perpessae sumus,	fle&tu_ ri^ga_ti&s le^vi^a^ pe_rpe&ss[ae] su^mu&s 	X_^_X^^^_X_^X	0.5
Si flenda patimur. Ilium uobis modo,	si& fle_nda^ pa^ti^mu&r i_li^u&m vo&bi&s mo^do& 	X_^^^X_^_X_^X	1.0
Mihi cecidit olim, cum ferus curru incito	mi^hi^ ce^ci^di^t o_li&m cu&m fe^ru&s cu_rru& i_nci^to&	^^^^^_X_^_X_^X	v
Mea membra raperet et graui gemeret sono	me^a^ me_mbra^ ra^pe^re&t e&t gra^vi_ ge^me^re&t so^no& 	^^_^^^X_^_^^_^X	1.0
Peliacus axis pondere Hectoreo tremens.	pe&li^a^cu^s a_xi&s po_nde^re& he_cto^re^o& tre^me&ns	X^^^_X_^_^^_^X	m
Tunc obruta atque euersa quodcumque accidit	tu&nc o_bru^ta& a_tqve& [eu]e_rsa^ qvo_dcu&mqve& a_cci^di&t 	X_^_X_^_X_^X	1.0
Torpens malis rigensque sine sensu fero.	to&rpe&ns ma^li&s ri&ge_nsqve^ si^ne^ se&nsu_ fe^ro& 	X_^_X_^^^X_^X	0.92
Iam erepta Danais coniugem sequerer meum,	ja&m e&re_pta^ da^na^i&s co_nju^ge&m se^qve^re&r me^u&m 	X_^^^X_^_^^_^X	1.0
Nisi hic teneret: hic meos animos domat	ni&si& hi&c te^ne_re&t hi&c me^o_s a^ni^mo&s do^ma&t 	X_^_X_^_^^_^X	1.0
Morique prohibet; cogit hic aliquid deos	mo&ri_qve^ pro^hi^be&t co_gi^t hi_c a^li^qvi&d de^o&s	X_^^^X_^_^^_^X	m
Adhuc rogare, tempus aerumnae addidit.	a&dhu&c ro^ga_re& te_mpu^s [ae]ru&mn[ae] a_ddi^di&t 	X_^_X_^_X_^X	1.0
Hic mihi malorum maximum fructum abstulit,	hi&c mi^hi^ ma^lo_ru&m ma_xi^mu&m fru&ctu&m a_bstu^li&t 	X^^^_X_^_X_^X	0.81
Nihil timere: prosperis rebus locus	ni&hi&l ti^me_re& pro_spe^ri_s re&bu&s lo^cu&s 	X_^_X_^_X_^X	1.0
Ereptus omnis, dura qua ueniant habent.	e&re_ptu^s o_mni&s du_ra^ qva_ ve^ni^a&nt ha^be&nt 	X_^_X_^_^^_^X	m
Miserrimum est timere, cum speres nihil.	mi&se_rri^mu&m e&st ti&me_re^ cu&m spe&re&s ni^hi&l 	X_^_X_^_X_^X	1.0
Quis te repens commouit afflictam metus?	qvi&s te_ re^pe&ns co&mmo_vi^t a_ffli&cta&m me^tu&s 	X_^_X_^_X_^X	1.0
Exoritur aliquod maius ex magno malum.	e&xo^ri^tu^r a^li^qvo&d ma_ju^s e&x ma&gno_ ma^lu&m 	X^^^^^X_^_X_^X	0.72
Nondum ruentis Ilii fatum stetit.	no&ndu&m ru^e_nti&s i_li^i_ fa&tu&m ste^ti&t 	X_^_X_^_X_^X	1.0
Et quas reperiet, ut uelit, clades deus?	e&t qva&s re^pe^ri^e&t u&t ve^li&t cla&de&s de^u&s	X_^^^X_^_X_^X	m
Stygis profundae claustra et obscuri specus	sty&gi&s pro^fu_nd[ae] cl[au]stra& e^t o_bscu&ri& spe^cu&s 	X_^_X_^_X_^X	1.0
Laxantur et, ne desit euersis metus,	la&xa_ntu^r e&t ne& de_si^t [eu]e&rsi&s me^tu&s 	X_^_X_^_X_^X	1.0
Hostes ab imo conditi Dite exeunt -	ho_ste_s a^b i_mo_ co_ndi^ti_ di&te& e_xe^u&nt - 	X_^_X_^_X_^X	m
Solisne retro peruium est Danais iter?	so&li_sne^ re_tro& pe_rvi^u&m e&st da^na^i_s i^te&r 	X_^_X_^_^^_^X	0.65
Certe aequa mors est! - turbat atque agitat Phrygas	ce&rte& [ae]qva^ mo&rs e&st tu_rba^t a_tqve& a^gi^ta&t phry^ga&s 	X_^_X_^_^^_^X	1.0
Communis iste terror; hic proprie meum	co&mmu_ni^s i_ste& te_rro^r hi&c pro^pri^e_ me^u&m	X_^_X_^_^^_^X	m
Exterret animum, noctis horrendae sopor.	e&xte_rre^t a^ni^mu&m no_cti^s ho_rre&nd[ae] so^po&r 	X_^^^X_^_X_^X	1.0
Quae uisa portas? effer in medium metus.	qv[ae] vi_sa^ po_rta&s e_ffe^r i&n me^di^u&m me^tu&s 	X_^_X_^_^^_^X	1.0
Partes fere nox alma transierat duas	pa&rte&s fe^re_ no&x a_lma^ tra_nsi^e^ra&t du^a&s 	X_^_X_^_^^_^X	1.0
Clarumque septem uerterant stellae iugum;	cla&ru_mqve^ se_pte&m ve_rte^ra&nt ste&ll[ae] ju^gu&m 	X_^_X_^_X_^X	1.0
Ignota tandem uenit afflictae quies	i&gno_ta^ ta_nde&m ve_ni^t a_ffli&ctae& qvi^e&s 	X_^_X_^_X_^X	0.43
Breuisque fessis somnus obrepsit genis,	bre&vi_sqve^ fe_ssi&s so_mnu^s o_bre&psi_t ge^ni&s 	X_^_X_^_X_^X	1.0
Si somnus ille est mentis attonitae stupor:	si& so_mnu^s i_lle& e&st me_nti^s a_tto^ni^t[ae] stu^po&r 	X_^_X_^_^^_^X	1.0
Cum subito nostros Hector ante oculos stetit,	cu&m su^bi^to^ no_stro&s he_cto^r a_nte& o^cu^lo&s ste^ti&t, 	X^^^_X_^_^^_^X	m
Non qualis ultro bella in Argiuos ferens	no&n qva_li^s u_ltro& be_lla& i^n a_rgi&vo&s fe^re&ns 	X_^_X_^_X_^X	1.0
Graias petebat facibus Idaeis rates,	gra&ja&s pe^te_ba&t fa^ci^bu^s i_d[ae]i&s ra^te&s 	X_^_X^^^_X_^X	1.0
Nec caede multa qualis in Danaos furens	ne&c c[ae]de^ mu_lta& qva_li^s i&n da^na^o&s fu^re&ns 	X_^_X_^_^^_^X	1.0
Vera ex Achille spolia simulato tulit;	ve&ra& e&x a^chi_lle& spo^li^a^ si^mu^la&to_ tu^li&t 	X_^_X^^^^^X_^X	1.0
Non ille uultus flammeum intendens iubar,	no&n i_lle^ vu_ltu&s fla_mme^u&m i_nte&nde&ns ju^ba&r 	X_^_X_^_X_^X	1.0
Sed fessus ac deiectus et fletu grauis	se&d fe_ssu^s a&c d[ei]e_ctu^s e&t fle&tu& gra^vi&s 	X_^_X_^_X_^X	1.0
Similisque nostro, squalida obtectus coma.	si^mi^li_sqve^ no_stro& sqva_li^da& o_bte&ctu&s co^ma& 	^^_^_X_^_X_^X	1.0
Iuuat tamen uidisse. tum quassans caput:	ju&va&t ta^me&n vi&di_sse^ tu&m qva&ssa&ns ca^pu&t 	X_^_X_^_X_^X	1.0
'Dispelle somnos' inquit 'et natum eripe,	di&spe_lle^ so_mno&s i_nqvi^t e&t na&tu&m e_ri^pe& 	X_^_X_^_X_^X	1.0
O fida coniunx: lateat, haec una est salus.	o& fi_da^ co_nju&nx la^te^a^t h[ae]c u&na& e&st sa^lu&s 	X_^_X^^^_X_^X	1.0
Omitte fletus - Troia quod cecidit gemis?	o&mi_tte^ fle_tu&s tro_ja^ qvo&d ce^ci^di&t ge^mi&s 	X_^_X_^_^^_^X	0.66
Vtinam iaceret tota. festina, amoue	u^ti^na&m ja^ce_re&t to_ta^ fe_sti&na& a_mo^ve& 	^^_^_X_^_X_^X	1.0
Quocumque nostrae paruulam stirpem domus.'	qvo&cu_mqve^ no_str[ae] pa_rvu^la_m sti&rpe&m do^mu&s 	X_^_X_^_X_^X	1.0
Mihi gelidus horror ac tremor somnum excutit,	mi^hi^ ge^li^du^s ho_rro&r a&c tre^mo&r so&mnu&m e_xcu^ti&t 	^^^^^_X_^_X_^X	0.81
Oculosque nunc huc pauida, nunc illuc ferens	o^cu^lo_sqve^ nu&nc hu&c pa^vi^da^ nu&nc i&llu&c fe^re&ns 	^^_^_X^^^_X_^X	1.0
Oblita nati misera quaesiui Hectorem:	o&bli_ta^ na_ti& mi^se^ra^ qv[ae]si&ui& he_cto^re&m 	X_^_X^^^_X_^X	0.84
Fallax per ipsos umbra complexus abit.	fa&lla&x pe^r i_pso&s u_mbra^ co_mple&xu_s a^bi&t 	X_^_X_^_X_^X	0.14
O nate, magni certa progenies patris,	o& na_te^ ma_gni& ce_rta^ pro_ge^ni^e&s pa^tri&s 	X_^_X_^_^^_^X	0.55
Spes una Phrygibus, unica afflictae domus,	spe&s u_na^ phry^gi^bu&s u_ni^ca& a_ffli&ctae_ do^mu&s 	X_^^^X_^_X_^X	1.0
Veterisque suboles sanguinis nimium inclita	ve^te^ri_sqve^ su^bo^le&s sa_ngvi^ni&s ni^mi^u&m i_ncli^ta& 	^^_^^^X_^_^^_^X	1.0
Nimiumque patri similis. hos uultus meus	ni^mi^u_mqve^ pa_tri& si^mi^li^s ho&s vu&ltu&s me^u&s 	^^_^_X^^^_X_^X	0.46
Habebat Hector, talis incessu fuit	ha&be_ba^t he_cto&r ta_li^s i_nce&ssu_ fu^i&t 	X_^_X_^_X_^X	0.87
Habituque talis, sic tulit fortes manus,	ha^bi^tu_qve^ ta_li&s si&c tu^li&t fo&rte&s ma^nu&s 	^^_^_X_^_X_^X	1.0
Sic celsus umeris, fronte sic torua minax	si&c ce_lsu^s u^me^ri&s fro_nte^ si&c to&rva_ mi^na&x 	X_^^^X_^_X_^X	1.0
Ceruice fusam dissipans iacta comam -	ce&rvi_ce^ fu_sa&m di_ssi^pa_ns ja&cta_ co^ma&m 	X_^_X_^_X_^X	1.0
O nate sero Phrygibus, o matri cito,	o& na_te^ se_ro& phry^gi^bu^s o_ ma&tri_ ci^to& 	X_^_X^^^_X_^X	1.0
Eritne tempus illud ac felix dies	e&ri_tne^ te_mpu&s i_llu^d a&c fe&li&x di^e&s 	X_^_X_^_X_^X	1.0
Quo Troici defensor et uindex soli	quo& tro_i^ci_ de_fe_nso^r e_t ui_nde&x so^li& 	X_^_X_^_X_^X	m
Recidiua ponas Pergama et sparsos fuga	re^ci^di_va^ po_na&s pe_rga^ma& e&t spa&rso&s fu^ga& 	^^_^_X_^_X_^X	1.0
Ciues reducas, nomen et patriae suum	ci&ve&s re^du_ca&s no_me^n e&t pa^tri^[ae] su^u&m 	X_^_X_^_^^_^X	1.0
Phrygibusque reddas? sed mei fati memor	phry^gi^bu_sqve^ re_dda&s se&d me^i_ fa&ti_ me^mo&r 	^^_^_X_^_X_^X	1.0
Tam magna timeo uota - quod captis sat est,	ta&m ma_gna^ ti^me^o& vo_ta^ qvo&d ca&pti&s sa^t e&st 	X_^^^X_^_X_^X	1.0
Viuamus. Heu me, quis locus fidus meo	vi&va_mu^s h[eu] me& qvi&s lo^cu&s fi&du&s me^o& 	X_^_X_^_X_^X	1.0
Erit timori quaue te sede occulam?	e&ri&t ti^mo_ri& qv[au]e^ te_ se&de& o_ccu^la&m 	X_^_X_^_X_^X	1.0
Arx illa pollens opibus et muris deum,	a&rx i_lla^ po_lle&ns o^pi^bu^s e&t mu&ri&s de^u&m 	X_^_X^^^_X_^X	1.0
Gentes per omnes clara et inuidiae grauis,	ge&nte&s pe^r o_mne&s cla_ra& e^t i_nvi^di^[ae] gra^vi&s 	X_^_X_^_^^_^X	1.0
Nunc puluis altus, strata sunt flamma omnia	nu&nc pu_lvi^s a_ltu&s stra_ta^ su&nt fla&mma& o_mni^a& 	X_^_X_^_X_^X	0.8
Superestque uasta ex urbe ne tantum quidem,	su^pe^re_stqve^ va_sta& e&x u_rbe^ ne_ ta&ntu&m qvi^de&m 	^^_^_X_^_X_^X	0.98
Quo lateat infans. quem locum fraudi legam?	qvo& la^te^a^t i_nfa&ns qve&m lo^cu&m fr[au]di_ le^ga&m 	X^^^_X_^_X_^X	1.0
Est tumulus ingens coniugis cari sacer,	e&st tu^mu^lu^s i_nge&ns co_nju^gi&s ca&ri_ sa^ce&r 	X^^^_X_^_X_^X	1.0
Verendus hosti, mole quem immensa parens	ve&re_ndu^s ho_sti& mo_le^ qve&m i_mme&nsa_ pa^re&ns 	X_^_X_^_X_^X	0.97
Opibusque magnis struxit, in luctus suos	o^pi^bu_sqve^ ma_gni&s stru_xi^t i&n lu&ctu&s su^o&s 	^^_^_X_^_X_^X	1.0
Rex non auarus: optume credam patri -	re&x no_n a^va_ru&s o_ptu^me_ cre&da&m pa^tri& 	X_^_X_^_X_^X	0.54
Sudor per artus frigidus totos cadit:	su&do&r pe^r a_rtu&s fri_gi^du&s to&to&s ca^di&t 	X_^_X_^_X_^X	1.0
Omen tremesco misera feralis loci.	o&me&n tre^me_sco& mi^se^ra^ fe_ra&li&s lo^ci& 	X_^_X^^^_X_^X	1.0
Miser occupet praesidia, securus legat.	mi^se^r o_ccu^pe&t pr[ae]si^di^a^ se_cu&ru&s le^ga&t 	^^_^_X^^^_X_^X	1.0
Quid quod latere sine metu magno nequit,	qvi&d qvo&d la^te_re& si^ne^ me^tu_ ma&gno_ ne^qvi&t 	X_^_X^^^_X_^X	0.14
Ne prodat aliquis? Amoue testes doli.	ne& pro_da^t a^li^qvi&s a_mo^ve_ te&ste&s do^li& 	X_^^^X_^_X_^X	1.0
Si quaeret hostis? Vrbe in euersa perit:	si& qv[ae]re^t ho_sti&s u_rbe& i^n [eu]e&rsa_ pe^ri&t 	X_^_X_^_X_^X	1.0
Haec causa multos una ab interitu arcuit,	h[ae]c c[au]sa^ mu_lto&s u_na& a^b i_nte^ri^tu& a_rcu^i&t 	X_^_X_^_^^_^X	1.0
Credi perisse. Vix spei quicquam est super:	cre_di_ pe^ri_sse&. vi&x spe^i_ qui_cqua&m e&st su^pe&r: 	X_^_X_^_X_^X	m
Graue pondus illum magna nobilitas premit;	gra^ve^ po_ndu^s i_llu&m ma_gna^ no_bi^li^ta&s pre^mi&t 	^^_^_X_^_^^_^X	1.0
Quid proderit latuisse redituro in manus?	qvi&d pro_de^ri^t la^tu&i_sse^ re^di^tu&ro& i&n ma^nu&s	X_^^^X_^^^X_^X	m
Victor feroces impetus primos habet.	vi&cto&r fe^ro_ce&s i_mpe^tu&s pri&mo_s ha^be&t 	X_^_X_^_X_^X	1.0
Quis te locus, quae regio seducta, inuia	qui&s te_ lo^cu&s, qu[ae] re^gi^o^ se_du_cta&, i_nui^a& 	X_^_X^^^_X_^X	m
Tuto reponet? quis feret trepidis opem?	tu&to_ re^po_ne&t qvi&s fe^re&t tre^pi^di_s o^pe&m 	X_^_X_^_^^_^X	1.0
Quis proteget? qui semper, etiamnunc tuos,	qvi&s pro_te^ge&t qvi& se_mpe^r e^ti^a&mnu&nc tu^o&s 	X_^_X_^^^X_^X	1.0
Hector, tuere: coniugis furtum piae	he&cto&r tu^e_re& co_nju^gi&s fu&rtu&m pi^[ae] 	X_^_X_^_X_^X	1.0
Serua et fideli cinere uicturum excipe.	se&rva& e&t fi^de_li& ci^ne^re^ vi_ctu&ru&m e_xci^pe& 	X_^_X^^^_X_^X	1.0
Succede tumulo, nate - quid retro fugis?	su&cce_de^ tu^mu^lo& na_te^ qvi&d re&tro_ fu^gi&s 	X_^^^X_^_X_^X	1.0
Turpesne latebras spernis? agnosco indolem:	tu&rpe_sne^ la^te^bra&s spe_rni^s a_gno&sco& i_ndo^le&m 	X_^^^X_^_X_^X	0.57
Pudet timere. spiritus magnos fuga	pu&de&t ti^me_re& spi_ri^tu&s ma&gno&s fu^ga& 	X_^_X_^_X_^X	1.0
Animosque ueteres, sume quos casus dedit.	a^ni^mo_sqve^ ve^te^re&s su_me^ qvo&s ca&su&s de^di&t 	^^_^^^X_^_X_^X	1.0
En intuere, turba quae simus super:	e&n i_ntu^e_re& tu_rba^ qv[ae] si&mu&s su^pe&r 	X_^_X_^_X_^X	1.0
Tumulus, puer, captiua: cedendum est malis.	tu^mu^lu&s pu^e&r ca&pti_va^ ce_de&ndu&m e&st ma^li&s 	^^_^_X_^_X_^X	0.92
Sanctas parentis conditi sedes age	sa&ncta&s pa^re_nti&s co_ndi^ti_ se&de_s a^ge& 	X_^_X_^_X_^X	1.0
Aude subire. fata si miseros iuuant,	[au]de_ su^bi_re& fa_ta^ si_ mi^se^ro&s ju^va&nt 	X_^_X_^_^^_^X	1.0
Habes salutem; fata si uitam negant,	ha&be&s sa^lu_te&m fa_ta^ si_ vi&ta&m ne^ga&nt 	X_^_X_^_X_^X	1.0
Habes sepulcrum. Claustra commissum tegunt;	ha&be&s se^pu_lcru&m cl[au]stra^ co_mmi&ssu&m te^gu&nt 	X_^_X_^_X_^X	1.0
Quem ne tuus producat in medium timor,	qve&m ne_ tu^u&s pro&du_ca^t i&n me^di^u&m ti^mo&r 	X_^_X_^_^^_^X	1.0
Procul hinc recede teque diuersam amoue.	pro^cu^l hi&nc re^ce_de& te_qve^ di_ve&rsa&m a_mo^ve& 	^^_^_X_^_X_^X	0.99
Leuius solet timere, qui propius timet;	le^vi^u&s so^le&t ti&me_re^ qvi& pro^pi^u&s ti^me&t 	^^_^_X_^_^^_^X	1.0
Sed, si placet, referamus hinc alio pedem.	se&d si& pla^ce&t re^fe^ra_mu^s hi&nc a^li^o_ pe^de&m	X_^_^^_^_^^_^X	m
Cohibe parumper ora questusque opprime:	co^hi^be_ pa^ru_mpe&r o_ra^ qve_stu&sqve& o_ppri^me&	^^_^_X_^_X_^X	m
Gressus nefandos dux Cephallanum admouet.	gre&ssu&s ne^fa_ndo&s du&x ce^pha_lla&nu&m a_dmo^ve&t 	X_^_X_^_X_^X	1.0
Dehisce tellus, tuque, coniunx, ultimo	de&hi_sce^ te_llu&s tu_qve^ co_nju&nx u_lti^mo& 	X_^_X_^_X_^X	1.0
Specu reuulsam scinde tellurem et Stygis	spe&cu_ re^vu_lsa&m sci_nde^ te_llu&re&m e&t sty^gi&s 	X_^_X_^_X_^X	1.0
Sinu profundo conde depositum meum.	si&nu& pro^fu_ndo& co_nde^ de_po^si^tu&m me^u&m 	X_^_X_^_^^_^X	1.0
Adest Vlixes, et quidem dubio gradu	a&de&st u^li_xe&s e&t qvi^de&m du^bi^o& gra^du& 	X_^_X_^_^^_^X	1.0
Vultuque: nectit pectore astus callidos.	vu&ltu_qve^ ne_cti&t pe_cto^re& a_stu&s ca_lli^do&s 	X_^_X_^_X_^X	1.0
Durae minister sortis hoc primum peto,	du&r[ae] mi^ni_ste&r so_rti^s ho&c pri&mu&m pe^to& 	X_^_X_^_X_^X	0.8
Vt, ore quamuis uerba dicantur meo,	u&t o_re^ qva_mvi&s ve_rba^ di_ca&ntu&r me^o& 	X_^_X_^_X_^X	1.0
Non esse credas nostra: Graiorum omnium	no&n e_sse^ cre_da&s no_stra^ gra_jo&ru&m o_mni^u&m 	X_^_X_^_X_^X	1.0
Procerumque uox est, petere quos seras domos	pro^ce^ru_mqve^ vo&x e&st pe^te^re^ qvo&s se&ra&s do^mo&s 	^^_^_X^^^_X_^X	1.0
Hectorea suboles prohibet: hanc fata expetunt.	he&cto^re^a^ su^bo^le&s pro^hi^be^t ha&nc fa&ta& e_xpe^tu&nt 	X^^^^^X^^^_X_^X	1.0
Sollicita Danaos pacis incertae fides	so&lli^ci^ta^ da^na^o&s pa_ci^s i_nce&rt[ae] fi^de&s 	X^^^^^X_^_X_^X	1.0
Semper tenebit, semper a tergo timor	se&mpe&r te^ne_bi&t se_mpe^r a_ te&rgo_ ti^mo&r 	X_^_X_^_X_^X	1.0
Respicere coget arma nec poni sinet,	re&spi^ce^re^ co_ge&t a_rma^ ne&c po&ni_ si^ne&t 	X^^^_X_^_X_^X	1.0
Dum Phrygibus animos natus euersis dabit,	du&m phry^gi^bu^s a^ni^mo&s na_tu^s [eu]e&rsi&s da^bi&t 	X^^^^^X_^_X_^X	1.0
Andromacha, uester. augur haec Calchas canit;	a&ndro^ma^cha^ ve_ste&r [au]gu^r h[ae]c ca&lcha&s ca^ni&t 	X^^^_X_^_X_^X	1.0
Et, si taceret augur haec Calchas, tamen	e&t si_ ta^ce_re&t [au]gu^r h[ae]c ca&lcha&s ta^me&n 	X_^_X_^_X_^X	1.0
Dicebat Hector, cuius et stirpem horreo.	di&ce_ba^t he_cto&r cu_ju^s e&t sti&rpe&m ho_rre^o& 	X_^_X_^_X_^X	1.0
Generosa in ortus semina exsurgunt suos:	ge^ne^ro_sa& i^n o_rtu&s se_mi^na& e_xsu&rgu&nt su^o&s 	^^_^_X_^_X_^X	1.0
Sic ille magni paruus armenti comes	si&c i_lle^ ma_gni& pa_rvu^s a_rme&nti_ co^me&s 	X_^_X_^_X_^X	1.0
Primisque nondum cornibus findens cutem	pri&mi_sqve^ no_ndu&m co_rni^bu&s fi&nde&ns cu^te&m 	X_^_X_^_X_^X	1.0
Ceruice subito celsus et fronte arduus	ce&rvi_ce^ su^bi^to& ce_lsu^s e&t fro&nte& a_rdu^u&s 	X_^^^X_^_X_^X	1.0
Gregem paternum ducit ac pecori imperat;	gre&ge&m pa^te_rnu&m du_ci^t a&c pe^co^ri& i_mpe^ra&t 	X_^_X_^_^^_^X	1.0
Quae tenera caeso uirga de trunco stetit,	qv[ae] te^ne^ra^ c[ae]so& vi_rga^ de& tru&nco& ste^ti&t 	X^^^_X_^_X_^X	1.0
Par ipsa matri tempore exiguo subit	pa&r i_psa^ ma_tri& te_mpo^re& e_xi^gu^o_ su^bi&t 	X_^_X_^_^^_^X	1.0
Vmbrasque terris reddit et caelo nemus;	u&mbra_sqve^ te_rri&s re_ddi^t e&t c[ae]lo_ ne^mu&s 	X_^_X_^_X_^X	1.0
Sic male relictus igne de magno cinis	si&c ma^le^ re^li_ctu&s i_gne^ de_ ma&gno_ ci^ni&s 	X^^^_X_^_X_^X	1.0
Vires resumit. Est quidem iniustus dolor	vi&re&s re^su_mi&t e&st qvi^de&m i_nju&stu&s do^lo&r 	X_^_X_^_X_^X	1.0
Rerum aestimator: si tamen tecum exigas,	re&ru&m [ae]sti^ma_to&r si_ ta^me&n te&cu&m e_xi^ga&s 	X_^_X_^_X_^X	1.0
Veniam dabis, quod bella post hiemes decem	ve^ni^a&m da^bi&s qvo&d be_lla^ po&st hi^e^me&s de^ce&m 	^^_^_X_^_^^_^X	1.0
Totidemque messes iam senex miles timet	to^ti^de_mqve^ me_sse&s ja&m se^ne&x mi&le&s ti^me&t 	^^_^_X_^_X_^X	1.0
Aliasque clades rursus ac numquam bene	a^li^a_sqve^ cla_de&s ru_rsu^s a&c nu&mqva&m be^ne& 	^^_^_X_^_X_^X	1.0
Troiam iacentem. magna res Danaos mouet,	tro&ja&m ja^ce_nte&m ma_gna^ re&s da^na^o&s mo^ve&t 	X_^_X_^_^^_^X	1.0
Futurus Hector: libera Graios metu.	fu&tu_ru^s he_cto&r li_be^ra_ gra&jo&s me^tu& 	X_^_X_^_X_^X	1.0
Haec una naues causa deductas tenet,	h[ae]c u_na^ n[au]e&s c[au]sa^ de_du&cta&s te^ne&t 	X_^_X_^_X_^X	1.0
Hic classis haeret. neue crudelem putes,	hi&c cla_ssi^s h[ae]re&t n[eu]e^ cru_de&le&m pu^te&s 	X_^_X_^_X_^X	0.75
Quod sorte iussus Hectoris natum petam:	qvo&d so_rte^ ju_ssu&s he_cto^ri&s na&tu&m pe^ta&m 	X_^_X_^_X_^X	1.0
Petissem Oresten. patere quod uictor tulit.	pe&ti_sse&m o^re_ste&n pa^te^re^ qvo&d vi&cto&r tu^li&t 	X_^_X^^^_X_^X	0.5
Vtinam quidem esses, nate, materna in manu,	u^ti^na&m qvi^de&m e_sse&s na_te^ ma_te&rna& i&n ma^nu& 	^^_^_X_^_X_^X	1.0
Nossemque quis te casus ereptum mihi	no&sse_mqve^ qvi&s te& ca_su^s e_re&ptu&m mi^hi& 	X_^_X_^_X_^X	0.39
Teneret, aut quae regio - non hostilibus	te&ne_re^t, [au]t qu[ae] re^gi^o^ - no&n ho_sti_li^bu&s 	X_^_X^^^_X_^X	m
Confossa telis pectus ac uinclis manus	co&nfo_ssa^ te_li&s pe_ctu^s a&c vi&ncli&s ma^nu&s 	X_^_X_^_X_^X	1.0
Secantibus praestricta, non acri latus	se&ca_nti^bu&s pr[ae]stri_cta^ no_n a&cri_ la^tu&s 	X_^_X_^_X_^X	0.98
Vtrumque flamma cincta maternam fidem	u&tru_mqve^ fla_mma& ci_ncta^ ma_te&rna&m fi^de&m 	X_^_X_^_X_^X	1.0
Vmquam exuissem. nate, quis te nunc locus,	u&mqva&m e_xu^i_sse&m na_te^ qvi&s te& nu&nc lo^cu&s 	X_^_X_^_X_^X	1.0
Fortuna quae possedit? errore auio	fo&rtu_na^ qv[ae] po&sse_di^t e_rro&re& a_vi^o& 	X_^_X_^_X_^X	1.0
Vagus arua lustras? uastus an patriae uapor	va^gu^s a_rva^ lu_stra&s va_stu^s a&n pa^tri^[ae] va^po&r 	^^_^_X_^_^^_^X	1.0
Corripuit artus? saeuus an uictor tuo	co&rri^pu^i^t a_rtu&s s[ae]vu^s a&n vi&cto&r tu^o& 	X^^^_X_^_X_^X	1.0
Lusit cruore? numquid immanis ferae	lu&si&t cru^o_re& nu_mqvi^d i_mma&ni&s fe^r[ae] 	X_^_X_^_X_^X	1.0
Morsu peremptus pascis Idaeas aues?	mo&rsu_ pe^re_mptu&s pa_sci^s i_d[ae]a_s a^ve&s 	X_^_X_^_X_^X	1.0
Simulata remoue uerba; non facile est tibi	si^mu^la_ta^ re^mo^ve& ve_rba^ no&n fa^ci^le& e&st ti^bi& 	^^_^^^X_^_^^_^X	1.0
Decipere Vlixem: uicimus matrum dolos	de&ci^pe^re& u^li_xe&m vi_ci^mu&s ma&tru&m do^lo&s 	X^^^_X_^_X_^X	1.0
Etiam dearum. cassa consilia amoue;	e^ti^a&m de^a_ru&m ca_ssa^ co_nsi^li^a& a_mo^ve&	^^_^_X_^_^^_^X	m
Vbi natus est? Vbi Hector? ubi cuncti Phryges?	u^bi^ na_tu^s e&st u&bi& he_cto^r u^bi^ cu&ncti& phry^ge&s 	^^_^_X_^^^X_^X	1.0
Vbi Priamus? unum quaeris: ego quaero omnia.	u^bi^ pri^a^mu^s u_nu&m qv[ae]ri^s e^go^ qv[ae]ro& o_mni^a& 	^^^^^_X_^^^X_^X	0.99
Coacta dices sponte quod fari abnuis:	co&a_cta^ di_ce&s spo_nte^ qvo&d fa&ri& a_bnu^i&s 	X_^_X_^_X_^X	1.0
Stulta est fides celare quod prodas statim.	stu&lta& e&st fi^de&s ce&la_re^ qvo&d pro&da&s sta^ti&m 	X_^_X_^_X_^X	1.0
Tuta est, perire quae potest debet cupit.	tu&ta& e&st pe^ri_re& qv[ae] po^te&st de&be&t cu^pi&t 	X_^_X_^_X_^X	1.0
Magnifica uerba mors prope admota excutit.	ma&gni^fi^ca^ ve_rba& mo&rs pro^pe& a_dmo&ta& e_xcu^ti&t 	X^^^_X_^_X_^X	1.0
Si uis, Vlixe, cogere Andromacham metu,	si& vi_s u^li_xe& co_ge^re& a_ndro^ma^cha_m me^tu& 	X_^_X_^_^^_^X	0.75
Vitam minare: nam mori uotum est mihi.	vi&ta&m mi^na_re& na&m mo^ri_ vo&tu&m e&st mi^hi& 	X_^_X_^_X_^X	1.0
Verberibus igni morte cruciatu eloqui	ve&rbe^ri^bu^s i_gni& mo_rte^ cru^ci^a&tu& e_lo^qvi& 	X^^^_X_^^^X_^X	1.0
Quodcumque celas adiget inuitam dolor	qvo&dcu_mqve^ ce_la&s a^di^ge^t i_nvi&ta&m do^lo&r 	X_^_X^^^_X_^X	1.0
Et pectore imo condita arcana eruet:	e&t pe_cto^re& i_mo& co_ndi^ta& a_rca&na& e_ru^e&t 	X_^_X_^_X_^X	1.0
Necessitas plus posse quam pietas solet.	ne&ce_ssi^ta_s plu&s po_sse^ qva&m pi^e^ta&s so^le&t 	X_^_X_^_^^_^X	1.0
Propone flammas, uulnera et diras mali	pro&po_ne^ fla_mma&s vu_lne^ra& e&t di&ra&s ma^li& 	X_^_X_^_X_^X	0.82
Doloris artes et famem et saeuam sitim	do&lo_ri^s a_rte&s e&t fa^me&m e&t s[ae]va&m si^ti&m 	X_^_X_^_X_^X	1.0
Variasque pestes undique et ferrum inditum	va^ri^a_sqve^ pe_ste&s u_ndi^qve& e&t fe&rru&m i_ndi^tu&m 	^^_^_X_^_X_^X	1.0
Visceribus ipsis, carceris caeci luem,	vi&sce^ri^bu^s i_psi&s ca_rce^ri&s c[ae]ci_ lu^e&m 	X^^^_X_^_X_^X	1.0
Et quidquid audet uictor iratus tumens:	e&t qvi_dqvi^d [au]de&t vi_cto^r i_ra&tu&s tu^me&ns 	X_^_X_^_X_^X	1.0
Animosa nullos mater admittit metus.	a^ni^mo_sa^ nu_llo&s ma_te^r a_dmi&tti&t me^tu&s 	^^_^_X_^_X_^X	1.0
Hic ipse, quo nunc contumax perstas, amor	hi&c i_pse^ qvo_ nu&nc co_ntu^ma_x pe&rsta_s a^mo&r 	X_^_X_^_X_^X	1.0
Consulere paruis liberis Danaos monet.	co&nsu^le^re^ pa_rvi&s li_be^ri&s da^na^o&s mo^ne&t 	X^^^_X_^_^^_^X	1.0
Post arma tam longinqua, post annos decem	po&st a_rma^ ta&m lo&ngi_nqva^ po&st a&nno&s de^ce&m 	X_^_X_^_X_^X	1.0
Minus timerem quos facit Calchas metus,	mi&nu&s ti^me_re&m qvo&s fa^ci&t ca&lcha&s me^tu&s 	X_^_X_^_X_^X	1.0
Si mihi timerem: bella Telemacho paras.	si& mi^hi^ ti^me_re&m be_lla^ te_le^ma^cho_ pa^ra&s	X^^^_X_^_^^_^X	m
Inuita, Vlixe, gaudium Danais dabo:	i&nvi_ta& u^li_xe& g[au]di^u&m da^na^i&s da^bo& 	X_^_X_^_^^_^X	1.0
Dandum est; fatere quos premis luctus, dolor.	da&ndu&m e&st fa^te_re& qvo&s pre^mi&s lu&ctu&s do^lo&r 	X_^_X_^_X_^X	1.0
Gaudete, Atridae, tuque laetifica, ut soles,	g[au]de_te& a^tri_d[ae] tu_qve^ l[ae]ti^fi^ca& u&t so^le&s 	X_^_X_^_^^_^X	0.11
Refer Pelasgis: Hectoris proles obit.	re&fe&r pe^la_sgi&s he_cto^ri&s pro&le_s o^bi&t 	X_^_X_^_X_^X	1.0
Et esse uerum hoc qua probas Danais fide?	e&t e_sse^ ve_ru&m ho&c qva_ pro^ba&s da^na^i&s fi^de& 	X_^_X_^_^^_^X	0.97
Ita quod minari maximum uictor potest	i^ta^ qvo&d mi^na_ri& ma_xi^mu&m vi&cto&r po^te&st 	^^_^_X_^_X_^X	1.0
Contingat et me fata maturo exitu	co&nti_nga^t e&t me& fa_ta^ ma_tu&ro& e_xi^tu& 	X_^_X_^_X_^X	1.0
Facilique soluant ac meo condant solo	fa^ci^li_qve^ so_lva&nt a&c me^o_ co&nda&nt so^lo& 	^^_^_X_^_X_^X	0.71
Et patria tellus Hectorem leuiter premat,	e&t pa^tri^a^ te_llu&s he_cto^re_m le^vi^te&r pre^ma&t 	X^^^_X_^_^^_^X	0.95
Vt luce caruit: inter extinctos iacet	u&t lu_ce^ ca^ru^i&t i_nte^r e_xti&ncto&s ja^ce&t 	X_^^^X_^_X_^X	1.0
Datusque tumulo debita exanimis tulit.	da&tu_sqve^ tu^mu^lo& de_bi^ta& e_xa^ni^mi&s tu^li&t 	X_^^^X_^_^^_^X	1.0
Expleta fata stirpe sublata Hectoris	e&xple_ta^ fa_ta& sti_rpe^ su_bla&ta& he_cto^ri&s 	X_^_X_^_X_^X	1.0
Solidamque pacem laetus ad Danaos feram -	so^li^da_mqve^ pa_ce&m l[ae]tu^s a&d da^na^o&s fe^ra&m 	^^_^_X_^_^^_^X	1.0
Quid agis, Vlixe? Danaidae credent tibi:	qui&d a^gi^s, v^li_xe&? da^na^i^d[ae] cre_de&nt ti^bi&: 	X^^^_X^^^_X_^X	m
Tu cui? parenti: fingit an quisquam hoc parens,	tu& cu_j pa^re_nti& fi_ngi^t a&n qvi&sqva&m ho&c pa^re&ns 	X_^_X_^_X_^X	0.97
Nec abominandae mortis auspicium pauet?	ne^c a^bo_mi^na_nd[ae] mo_rti^s [au]spi^ci^u&m pa^ve&t	^^_^_X_^_^^_^X	m
Auspicia metuunt qui nihil maius timent.	[au]spi^ci^a^ me^tu^u&nt qvi_ ni^hi&l ma&ju&s ti^me&nt 	X^^^^^X_^_X_^X	1.0
Fidem alligauit iure iurando suam -	fi&de&m a_lli^ga_vi&t ju_re^ ju_ra&ndo& su^a&m 	X_^_X_^_X_^X	1.0
Si peierat, timere quid grauius potest?	si& p[ei]e^ra&t ti&me_re^ qvi&d gra^vi^u&s po^te&st 	X_^_X_^_^^_^X	1.0
Nunc aduoca astus, anime, nunc fraudes, dolos,	nu&nc a_dvo^ca& a_stu&s a^ni^me^ nu&nc fr[au]de&s do^lo&s 	X_^_X^^^_X_^X	1.0
Nunc totum Vlixem; ueritas numquam perit.	nu&nc to_tum v^li_xe_m; ue_ri^ta&s nu_mqua&m pe^ri&t. 	X_^_X_^_X_^X	m
Scrutare matrem: maeret, illacrimat, gemit;	scru&ta_re^ ma_tre&m m[ae]re^t i_lla^cri^ma&t ge^mi&t 	X_^_X_^_^^_^X	1.0
Sed huc et illuc anxios gressus refert	se&d hu_c e^t i_llu&c a_nxi^o_s gre&ssu&s re^fe&rt 	X_^_X_^_X_^X	0.92
Missasque uoces aure sollicita excipit:	mi&ssa_sqve^ vo_ce&s [au]re^ so_lli^ci^ta& e_xci^pi&t 	X_^_X_^_^^_^X	0.99
Magis haec timet, quam maeret. ingenio est opus.	ma^gi^s h[ae]c ti^me&t qva&m m[ae]re^t i_nge^ni^o& e&st o^pu&s 	^^_^_X_^_^^_^X	1.0
Alios parentes alloqui in luctu decet:	a^li^o&s pa^re_nte&s a_llo^qvi& i&n lu&ctu_ de^ce&t 	^^_^_X_^_X_^X	1.0
Tibi gratulandum est, misera, quod nato cares,	ti^bi^ gra_tu^la_ndu&m e&st mi^se^ra^ qvo&d na&to_ ca^re&s	^^_^_X^^^_X_^X	m
Quem mors manebat saeua praecipitem datum	qve&m mo&rs ma^ne_ba&t s[ae]va^ pr[ae]ci^pi^te&m da^tu&m 	X_^_X_^_^^_^X	1.0
E turre, lapsis sola quae muris manet.	e& tu_rre^ la_psi&s so_la^ qv[ae] mu&ri&s ma^ne&t 	X_^_X_^_X_^X	0.95
Reliquit animus membra, quatiuntur, labant	re&li_qvi^t a^ni^mu&s me_mbra^ qva^ti^u&ntu&r la^ba&nt 	X_^^^X_^^^X_^X	1.0
Torpetque uinctus frigido sanguis gelu.	to&rpe_tqve^ vi_nctu&s fri_gi^do_ sa&ngvi&s ge^lu& 	X_^_X_^_X_^X	1.0
Intremuit: hac, hac parte quaerenda est mihi;	i&ntre^mu^i^t ha_c ha&c pa_rte^ qv[ae]re&nda& e&st mi^hi& 	X^^^_X_^_X_^X	1.0
Matrem timor detexit: iterabo metum. -	ma&tre&m ti^mo&r de&te_xi^t i^te^ra&bo_ me^tu&m 	X_^_X_^^^X_^X	1.0
Ite, ite celeres, fraude materna abditum	i&te& i_te^ ce^le^re&s fr[au]de^ ma_te&rna& a_bdi^tu&m 	X_^^^X_^_X_^X	1.0
Hostem, Pelasgi nominis pestem ultimam,	ho&ste&m pe^la_sgi& no_mi^ni&s pe&ste&m u_lti^ma&m 	X_^_X_^_X_^X	1.0
Vbicumque latitat, erutam in medium date. -	u^bi^cu_mqve^ la^ti^ta&t e_ru^ta&m i&n me^di^u&m da^te& 	^^_^^^X_^_^^_^X	1.0
Bene est: tenetur. perge, festina, attrahe -	be&ne& e&st te^ne_tu&r pe_rge^ fe_sti&na& a_ttra^he& 	X_^_X_^_X_^X	1.0
Quid respicis trepidasque? iam certe perit.	qvi&d re_spi^ci&s tre^pi^da_sqve^ ja&m ce&rte_ pe^ri&t 	X_^_^^_^_X_^X	1.0
Vtinam timerem. solitus ex longo est metus:	u^ti^na&m ti^me_re&m so^li^tu^s e&x lo&ngo& e&st me^tu&s 	^^_^_X^^^_X_^X	1.0
Dediscit animus sero quod didicit diu.	de&di_sci^t a^ni^mu&s se_ro^ qvo&d di^di^ci&t di^u& 	X_^^^X_^_^^_^X	0.3
Lustrale quoniam debitum muris puer	lu&stra_le^ qvo^ni^a&m de_bi^tu&m mu&ri&s pu^e&r 	X_^^^X_^_X_^X	1.0
Sacrum antecessit nec potest uatem sequi	sa&cru&m a_nte^ce_ssi&t ne&c po^te&st va&te&m se^qvi& 	X_^_X_^_X_^X	1.0
Meliore fato raptus, hoc Calchas ait	me^li^o_re^ fa_to& ra_ptu^s ho&c ca&lcha_s a^i&t 	^^_^_X_^_X_^X	0.71
Modo piari posse redituras rates,	mo&do_ pi^a_ri& po_sse^ re^di^tu&ra&s ra^te&s 	X_^_X_^^^X_^X	0.05
Si placet undas Hectoris sparsi cinis	si& pla_ce^t u_nda&s he_cto^ri&s spa&rsi_ ci^ni&s 	X_^_X_^_X_^X	0.03
Ac tumulus imo totus aequetur solo.	a&c tu^mu^lu^s i_mo& to_tu^s [ae]qve&tu&r so^lo& 	X^^^_X_^_X_^X	0.71
Nunc ille quoniam debitam effugit necem,	nu&nc i_lle^ qvo^ni^a&m de_bi^ta&m e_ffu&gi&t ne^ce&m 	X_^^^X_^_X_^X	1.0
Erit admouenda sedibus sacris manus.	e^ri^t a_dmo^ve_nda& se_di^bu&s sa&cri&s ma^nu&s 	^^_^_X_^_X_^X	0.97
Quid agimus? animum distrahit geminus timor:	qvi&d a^gi^mu^s a^ni^mu&m di_stra^hi&t ge^mi^nu&s ti^mo&r 	X^^^^^X_^_^^_^X	1.0
Hinc natus, illinc coniugis cari cinis.	hi&nc na_tu^s i_lli&nc co_nju^gi&s ca&ri_ ci^ni&s 	X_^_X_^_X_^X	1.0
Pars utra uincet? testor immites deos,	pa&rs u_tra^ vi_nce&t te_sto^r i_mmi&te&s de^o&s 	X_^_X_^_X_^X	1.0
Deosque ueros coniugis manes mei:	de&o_sqve^ ve_ro&s co_nju^gi&s ma&ne&s me^i& 	X_^_X_^_X_^X	1.0
Non aliud, Hector, in meo nato mihi	no&n a^li^u^d he_cto&r i&n me^o_ na&to_ mi^hi& 	X^^^_X_^_X_^X	1.0
Placere quam te. uiuat, ut possit tuos	pla&ce_re^ qva&m te& vi_va^t u&t po&ssi&t tu^o&s 	X_^_X_^_X_^X	1.0
Referre uultus - prorutus tumulo cinis	re&fe_rre^ vu_ltu&s pro_ru^tu&s tu^mu^lo_ ci^ni&s 	X_^_X_^_^^_^X	1.0
Mergetur? ossa fluctibus spargi sinam	me&rge_tu^r o_ssa& flu_cti^bu&s spa&rgi_ si^na&m 	X_^_X_^_X_^X	1.0
Disiecta uastis? potius hic mortem oppetat. -	di&sje_cta^ va_sti&s po^ti^u^s hi&c mo&rte&m o_ppe^ta&t 	X_^_X^^^_X_^X	1.0
Poteris nefandae deditum mater neci	po^te^ri&s ne^fa_nd[ae] de_di^tu&m ma&te&r ne^ci& 	^^_^_X_^_X_^X	1.0
Videre, poteris celsa per fastigia	vi&de_re^ po^te^ri&s ce_lsa^ pe&r fa&sti_gi^a& 	X_^^^X_^_X_^X	1.0
Missum rotari? potero, perpetiar, feram,	mi_ssu&m ro^ta_ri&? po^te^ro^, pe_rpe^ti^a&r, fe^ra&m, 	X_^_X^^^_^^_^X	m
Dum non meus post fata uictoris manu	du&m no&n me^u&s po&st fa_ta^ vi_cto&ri&s ma^nu& 	X_^_X_^_X_^X	1.0
Iactetur Hector. - hic suam poenam potest	ja&cte_tu^r he_cto&r hi&c su^a&m p[oe]na&m po^te&st 	X_^_X_^_X_^X	0.5
Sentire, at illum fata iam in tuto locant -	se&nti_re& a^t i_llu&m fa_ta^ ja&m i&n tu&to_ lo^ca&nt 	X_^_X_^_X_^X	1.0
Quid fluctuaris? statue, quem poenae extrahas.	qvi&d flu_ctu^a_ri&s sta^tu^e^ qve&m p[oe]n[ae] e_xtra^ha&s 	X_^_X^^^_X_^X	1.0
Ingrata, dubitas? Hector est illinc tuus -	i&ngra_ta^ du^bi^ta&s he_cto^r e&st i&lli&nc tu^u&s 	X_^^^X_^_X_^X	1.0
Erras: utrimque est Hector; hic sensus potens,	e&rra_s u^tri_mqve& e&st he_cto^r hi&c se&nsu&s po^te&ns 	X_^_X_^_X_^X	1.0
Forsan futurus ultor extincti patris -	fo&rsa&n fu^tu_ru&s u_lto^r e_xti&ncti_ pa^tri&s 	X_^_X_^_X_^X	0.55
Vtrique parci non potest: quidnam facis?	u&tri_qve^ pa_rci& no&n po^te&st qvi&dna&m fa^ci&s 	X_^_X_^_X_^X	1.0
Serua e duobus, anime, quem Danai timent.	se&rva& e_ du^o_bu&s a^ni^me^ qve&m da^na^i_ ti^me&nt 	X_^_X^^^_^^_^X	1.0
Responsa peragam: funditus busta eruam.	re&spo_nsa^ pe^ra^ga&m fu_ndi^tu&s bu&sta& e_ru^a&m 	X_^^^X_^_X_^X	1.0
Quae uendidistis? Pergam et e summo aggere	qv[ae] ve_ndi^di_sti&s pe_rga&m e^t e_ su&mmo& a_gge^re& 	X_^_X_^_X_^X	1.0
Traham sepulcra. Caelitum appello fidem	tra&ha&m se^pu_lcra& c[ae]li^tu&m a_ppe&llo_ fi^de&m 	X_^_X_^_X_^X	1.0
Fidemque Achillis: Pyrrhe, genitoris tui	fi&de_mqve& a^chi_lli&s py_rrhe^ ge^ni^to&ri&s tu^i& 	X_^_X_^^^X_^X	1.0
Munus tuere. Tumulus hic campo statim	mu&nu&s tu^e_re& tu^mu^lu^s hi&c ca&mpo& sta^ti&m 	X_^_X^^^_X_^X	1.0
Toto iacebit. Fuerat hoc prorsus nefas	to&to_ ja^ce_bi&t fu^e^ra^t ho&c pro&rsu&s ne^fa&s 	X_^_X^^^_X_^X	1.0
Danais inausum. templa uiolastis, deos	da^na^i_s i^n[au]su&m te_mpla^ vi^o^la&sti&s de^o&s 	^^_^_X_^^^X_^X	1.0
Etiam fauentes: busta transierat furor.	e^ti^a&m fa^ve_nte&s bu_sta^ tra_nsi^e^ra&t fu^ro&r 	^^_^_X_^_^^_^X	1.0
Resistam, inermis offeram armatis manus,	re&si_sta&m i^ne_rmi&s o_ffe^ra&m a_rma&ti&s ma^nu&s 	X_^_X_^_X_^X	1.0
Dabit ira uires. qualis Argolicas ferox	da^bi^t i_ra^ vi_re&s qva_li^s a_rgo^li^ca&s fe^ro&x 	^^_^_X_^_^^_^X	1.0
Turmas Amazon strauit, aut qualis deo	tu&rma_s a^ma_zo&n str[au]i^t [au]t qva&li&s de^o& 	X_^_X_^_X_^X	1.0
Percussa Maenas entheo siluas gradu	pe&rcu_ssa^ m[ae]na&s e_nthe^o_ si&lva&s gra^du& 	X_^_X_^_X_^X	1.0
Armata thyrso terret atque expers sui	a&rma_ta^ thy_rso& te_rre^t a_tqve& e&xpe&rs su^i& 	X_^_X_^_X_^X	1.0
Vulnus dedit nec sensit, in medios ruam	vu&lnu&s de^di&t ne&c se_nsi^t i&n me^di^o&s ru^a&m 	X_^_X_^_^^_^X	1.0
Tumuloque cineris socia defenso cadam.	tu^mu^lo_qve^ ci^ne^ri&s so^ci^a^ de_fe&nso_ ca^da&m 	^^_^^^X^^^_X_^X	1.0
Cessatis et uos flebilis clamor mouet	ce&ssa_ti^s e&t vo&s fle_bi^li&s cla&mo&r mo^ve&t 	X_^_X_^_X_^X	1.0
Furorque cassus feminae? iussa ocius	fu&ro_rqve^ ca_ssu&s fe_mi^nae_ ju&ssa& o_ci^u&s 	X_^_X_^_X_^X	1.0
Peragite. Me, me sternite hic ferro prius.	pe&ra^gi^te^ me_ me& ste_rni^te& hi&c fe&rro& pri^u&s	X^^^_X_^_X_^X	m
Repellor, heu me. rumpe fatorum moras,	re&pe_llo^r h[eu] me& ru_mpe^ fa_to&ru&m mo^ra&s 	X_^_X_^_X_^X	1.0
Molire terras, Hector: ut Vlixem domes,	mo&li_re^ te_rra&s he_cto^r u^t u^li&xe_m do^me&s 	X_^_X_^^^X_^X	1.0
Vel umbra satis es - arma concussit manu,	ve&l u_mbra^ sa^ti^s e&s a_rma^ co_ncu&ssi&t ma^nu& 	X_^^^X_^_X_^X	0.98
Iaculatur ignes - cernitis, Danai, Hectorem?	ja^cu^la_tu^r i_gne&s ce_rni^ti&s da^na^i& he_cto^re&m 	^^_^_X_^_^^_^X	1.0
An sola uideo? Funditus cuncta eruam.	a&n so_la^ vi^de^o& fu_ndi^tu&s cu&ncta& e_ru^a&m 	X_^^^X_^_X_^X	0.97
Quid agis? ruina mater et gnatum et uirum	qvi^d a^gi&s ru^i_na& ma_te^r e&t gna&tu&m e&t vi^ru&m 	^^_^_X_^_X_^X	0.8
Prosternis una? forsitan Danaos prece	pro&ste_rni^s u_na& fo_rsi^ta&n da^na^o&s pre^ce& 	X_^_X_^_^^_^X	1.0
Placare poteris. conditum elidet statim	pla&ca_re^ po^te^ri&s co_ndi^tu&m e_li&de&t sta^ti&m 	X_^^^X_^_X_^X	1.0
Immane busti pondus - intereat miser	i&mma_ne^ bu_sti& po_ndu^s i_nte^re^a&t mi^se&r 	X_^_X_^_^^_^X	1.0
Vbicumque potius, ne pater natum obruat	u^bi^cu_mqve^ po^ti^u&s ne_ pa^te&r na&tu&m o_bru^a&t 	^^_^^^X_^_X_^X	1.0
Prematque patrem natus. - Ad genua accido	pre&ma_tqve^ pa_tre&m na_tu^s a&d ge^nu^a& a_cci^do&	X_^_X_^_^^_^X	m
Supplex, Vlixe, quamque nullius pedes	su&pple&x u^li_xe& qva_mqve^ nu_lli&u&s pe^de&s 	X_^_X_^_X_^X	1.0
Nouere dextram pedibus admoueo tuis.	no&ve_re^ de_xtra&m pe^di^bu^s a_dmo^ve^o_ tu^i&s	X_^_X^^^_^^_^X	m
Miserere matris et preces placidus pias	mi^se^re_re^ ma_tri&s e&t pre^ce&s pla^ci^du&s pi^a&s 	^^_^_X_^_^^_^X	1.0
Patiensque recipe, quoque te celsum altius	pa^ti^e_nsqve^ re^ci^pe& qvo_qve^ te_ ce&lsu&m a_lti^u&s 	^^_^^^X_^_X_^X	0.07
Superi leuarunt, mitius lapsos preme:	su^pe^ri_ le^va_ru&nt mi_ti^u&s la&pso&s pre^me& 	^^_^_X_^_X_^X	1.0
Misero datur quodcumque, fortunae datur.	mi^se^ro_ da^tu&r qvo&dcu_mqve^ fo_rtu&n[ae] da^tu&r 	^^_^_X_^_X_^X	1.0
Sic te reuisat coniugis sanctae torus,	si&c te_ re^vi_sa&t co_nju^gi&s sa&nct[ae] to^ru&s 	X_^_X_^_X_^X	1.0
Annosque, dum te recipit, extendat suos	a&nno_sqve^ du&m te& re^ci^pi^t e_xte&nda&t su^o&s 	X_^_X^^^_X_^X	1.0
Laerta; sic te iuuenis excipiat tuus,	la&e_rta^; si&c te_ iu^ue^ni^s e_xci^pi^a&t tu^u&s, 	X_^_X^^^_^^_^X	m
Et uota uincens uestra felici indole	e&t vo_ta^ vi_nce&ns ve_stra^ fe_li&ci& i_ndo^le& 	X_^_X_^_X_^X	1.0
Aetate auum transcendat, ingenio patrem.	[ae]ta_te& a^vu&m tra&nsce_nda^t i_nge^ni^o_ pa^tre&m 	X_^_X_^_^^_^X	0.71
Miserere matris: unicum adflictae mihi	mi^se^re_re^ ma_tri&s u_ni^cu&m a_dfli&ctae_ mi^hi& 	^^_^_X_^_X_^X	1.0
Solamen hic est. Exhibe natum et roga.	so&la_me^n hi_c e&st e_xhi^be_ na&tu&m e&t ro^ga& 	X_^_X_^_X_^X	0.99
Matris quidem me maeror attonitae mouet,	ma&tri&s qvi^de&m me& m[ae]ro^r a_tto^ni^t[ae] mo^ve&t 	X_^_X_^_^^_^X	1.0
Magis Pelasgae me tamen matres mouent,	ma&gi&s pe^la_sg[ae] me_ ta^me&n ma&tre&s mo^ve&nt 	X_^_X_^_X_^X	1.0
Quarum iste magnos crescit in luctus puer.	qva&ru&m i_ste^ ma_gno&s cre_sci^t i&n lu&ctu&s pu^e&r 	X_^_X_^_X_^X	1.0
Has, has ruinas urbis in cinerem datae	ha&s ha&s ru^i_na&s u_rbi^s i&n ci^ne^re&m da^t[ae] 	X_^_X_^_^^_^X	1.0
Hic excitabit? hae manus Troiam erigent?	hi&c e_xci^ta_bi&t h[ae] ma^nu&s tro&ja&m e_ri^ge&nt 	X_^_X_^_X_^X	1.0
Nullas habet spes Troia, si tales habet.	nu&lla_s ha^be&t spe&s tro_ja^ si_ ta&le_s ha^be&t 	X_^_X_^_X_^X	0.68
Non sic iacemus Troes, ut cuiquam metus	no&n si&c ja^ce_mu&s tro_e^s u&t cu&jqva&m me^tu&s 	X_^_X_^_X_^X	1.0
Possimus esse. spiritus genitor facit?	po&ssi_mu^s e_sse& spi_ri^tu&s ge^ni^to&r fa^ci&t 	X_^_X_^_^^_^X	1.0
Sed nempe tractus. ipse post Troiam pater	se&d ne_mpe^ tra_ctu&s i_pse^ po&st tro&ja&m pa^te&r 	X_^_X_^_X_^X	1.0
Posuisset animos, magna quos frangunt mala.	po^su^i_sse^t a^ni^mo&s ma_gna^ qvo&s fra&ngu&nt ma^la& 	^^_^^^X_^_X_^X	0.94
Si poena petitur (quae peti grauior potest?)	si& p[oe]na^ pe^ti^tu&r qv[ae] pe^ti& gra^vi^o&r po^te&st 	X_^^^X_^_^^_^X	1.0
Famulare collo nobili subeat iugum,	fa^mu^la_re^ co_llo& no_bi^li_ su^be^a&t ju^gu&m	^^_^_X_^_^^_^X	m
Seruire liceat. aliquis hoc regi negat?	se&rvi_re^ li^ce^a&t a^li^qvi^s ho&c re&gi_ ne^ga&t 	X_^^^X^^^_X_^X	1.0
Non hoc Vlixes, sed negat Calchas tibi.	no&n ho_c u^li_xe&s se&d ne^ga&t ca&lcha&s ti^bi& 	X_^_X_^_X_^X	1.0
O machinator fraudis et scelerum artifex,	o& ma_chi^na_to&r fr[au]di^s e&t sce^le^ru&m a_rti^fe&x 	X_^_X_^_^^_^X	1.0
Virtute cuius bellica nemo occidit,	vi&rtu_te^ cu_ju&s be_lli^ca_ ne&mo& o_cci^di&t 	X_^_X_^_X_^X	1.0
Dolis et astu maleficae mentis iacent	do&li_s e^t a_stu& ma^le^fi^c[ae] me&nti&s ja^ce&nt 	X_^_X^^^_X_^X	1.0
Etiam Pelasgi, uatem et insontes deos	e^ti^a&m pe^la_sgi& va_te&m e^t i_nso&nte&s de^o&s 	^^_^_X_^_X_^X	1.0
Praetendis? hoc est pectoris facinus tui.	pr[ae]te_ndi^s ho_c e&st pe_cto^ri&s fa^ci^nu&s tu^i& 	X_^_X_^_^^_^X	1.0
Nocturne miles, fortis in pueri necem	no&ctu_rne^ mi_le&s fo_rti^s i&n pu^e^ri_ ne^ce&m 	X_^_X_^_^^_^X	1.0
Iam solus audes aliquid et claro die.	ja&m so_lu^s [au]de&s a^li^qvi^d e&t cla&ro_ di^e& 	X_^_X^^^_X_^X	1.0
Virtus Vlixis Danaidis nota est satis	vi_rtu&s v^li_xi&s da^na^i^di&s no_ta& e&st sa^ti&s 	X_^_X^^^_X_^X	m
Nimisque Phrygibus. non uacat uanis diem	ni&mi_sqve^ phry^gi^bu&s no&n va^ca&t va&ni&s di^e&m 	X_^^^X_^_X_^X	1.0
Conterere uerbis: ancoras classis legit.	co&nte^re^re^ ve_rbi&s a_nco^ra_s cla&ssi&s le^gi&t 	X^^^_X_^_X_^X	0.74
Breuem moram largire, dum officium parens	bre&ve&m mo^ra&m la&rgi_re^ du&m o_ffi^ci^u&m pa^re&ns 	X_^_X_^_^^_^X	0.97
Nato supremum reddo et amplexu ultimo	na&to_ su^pre_mu&m re_ddo& e^t a_mple&xu& u_lti^mo& 	X_^_X_^_X_^X	0.5
Auidos dolores satio. Misereri tui	a^vi^do&s do^lo_re&s sa^ti^o^ mi^se^re&ri_ tu^i& 	^^_^_X^^^^^X_^X	1.0
Vtinam liceret. quod tamen solum licet,	u^ti^na&m li^ce_re&t qvo&d ta^me&n so&lu&m li^ce&t 	^^_^_X_^_X_^X	1.0
Tempus moramque dabimus. arbitrio tuo	te&mpu&s mo^ra_mqve& da^bi^mu^s a_rbi^tri^o_ tu^o& 	X_^_X^^^_^^_^X	1.0
Implere lacrimis: fletus aerumnas leuat.	i&mple_re^ la^cri^mi&s fle_tu^s [ae]ru&mna_s le^va&t 	X_^^^X_^_X_^X	0.33
O dulce pignus, o decus lapsae domus	o& du_lce^ pi_gnu&s o_ de^cu&s la&ps[ae] do^mu&s 	X_^_X_^_X_^X	1.0
Summumque Troiae funus, o Danaum timor,	su&mmu_mqve^ tro_j[ae] fu_nu^s o_ da^na^u&m ti^mo&r 	X_^_X_^_^^_^X	1.0
Genetricis o spes uana, cui demens ego	ge^ne^tri_ci^s o& spe&s va_na^ cu_j de&me&ns e^go& 	^^_^_X_^_X_^X	1.0
Laudes parentis bellicas, annos aui	l[au]de&s pa^re_nti&s be_lli^ca_s a&nno_s a^vi& 	X_^_X_^_X_^X	1.0
Medios precabar, uota destituit deus.	me^di^o&s pre^ca_ba&r vo_ta^ de_sti^tu^i&t de^u&s 	^^_^_X_^_^^_^X	1.0
Iliaca non tu sceptra regali potens	i&li^a^ca^ no&n tu& sce_ptra^ re_ga&li_ po^te&ns 	X^^^_X_^_X_^X	1.0
Gestabis aula, iura nec populis dabis	ge&sta_bi^s [au]la& ju_ra^ ne&c po^pu^li&s da^bi&s 	X_^_X_^_^^_^X	1.0
Victasque gentes sub tuum mittes iugum,	vi&cta_sqve^ ge_nte&s su&b tu^u&m mi&tte&s ju^gu&m 	X_^_X_^_X_^X	1.0
Non Graia caedes terga, non Pyrrhum trahes;	no&n gra_ja^ c[ae]de&s te_rga^ no&n py&rrhu_m tra^he&s 	X_^_X_^_X_^X	1.0
Non arma tenera parua tractabis manu	no&n a_rma^ te^ne^ra& pa_rva^ tra_cta&bi&s ma^nu& 	X_^^^X_^_X_^X	1.0
Sparsasque passim saltibus latis feras	spa&rsa_sqve^ pa_ssi&m sa_lti^bu&s la&ti&s fe^ra&s 	X_^_X_^_X_^X	1.0
Audax sequeris nec stato lustri die,	[au]da&x se^qve_ri&s ne&c sta^to_ lu&stri_ di^e& 	X_^_X_^_X_^X	0.33
Sollemne referens Troici lusus sacrum,	so_lle_mne^ re^fe^re&ns tro_i^ci_ lu_su&s sa^cru&m, 	X_^^^X_^_X_^X	m
Puer citatas nobilis turmas ages;	pu&e&r ci^ta_ta&s no_bi^li&s tu&rma_s a^ge&s 	X_^_X_^_X_^X	1.0
Non inter aras mobili uelox pede,	no&n i_nte^r a_ra&s mo_bi^li_ ve&lo&x pe^de& 	X_^_X_^_X_^X	1.0
Reboante flexo concitos cornu modos,	re^bo^a_nte^ fle_xo& co_nci^to&s co&rnu_ mo^do&s 	^^_^_X_^_X_^X	1.0
Barbarica prisco templa saltatu coles.	ba&rba^ri^ca^ pri_sco& te_mpla^ sa_lta&tu_ co^le&s 	X^^^_X_^_X_^X	1.0
O morte dira tristius leti genus!	o& mo_rte^ di_ra& tri_sti^u&s le&ti_ ge^nu&s 	X_^_X_^_X_^X	1.0
Flebilius aliquid Hectoris magni nece	fle&bi^li^u^s a^li^qvi&d he_cto^ri&s ma&gni_ ne^ce&	X^^^^^X_^_X_^X	m
Muri uidebunt. Rumpe iam fletus, parens:	mu&ri_ vi^de_bu&nt ru_mpe^ ja&m fle&tu&s pa^re&ns 	X_^_X_^_X_^X	0.97
Magnus sibi ipse non facit finem dolor.	ma&gnu&s si^bi& i_pse& no&n fa^ci&t fi&ne&m do^lo&r 	X_^_X_^_X_^X	1.0
Lacrimis, Vlixe, parua quam petimus mora est;	la^cri^mi_s u^li_xe& pa_rva^ qva&m pe^ti^mu&s mo^ra& e&st 	^^_^_X_^_^^_^X	0.88
Concede paucas, ut mea condam manu	co&nce_de^ p[au]ca&s u&t me^a_ co&nda&m ma^nu& 	X_^_X_^_X_^X	1.0
Viuentis oculos. occidis paruus quidem,	vi&ve_nti^s o^cu^lo&s o_cci^di&s pa&rvu&s qvi^de&m 	X_^^^X_^_X_^X	1.0
Sed iam timendus. Troia te expectat tua:	se&d ja&m ti^me_ndu&s tro_ja^ te& e_xpe&cta&t tu^a& 	X_^_X_^_X_^X	0.68
I, uade liber, liberos Troas uide.	i& va_de^ li_be&r li_be^ro_s tro&a&s vi^de& 	X_^_X_^_X_^X	0.98
Miserere, mater. Quid meos retines sinus	mi^se^re_re^ ma_te&r qvi&d me^o&s re^ti^ne&s si^nu&s 	^^_^_X_^_^^_^X	1.0
Manusque matris cassa praesidia occupas?	ma&nu_sqve^ ma_tri&s ca_ssa^ pr[ae]si^di^a& o_ccu^pa&s 	X_^_X_^_^^_^X	1.0
Fremitu leonis qualis audito tener	fre^mi^tu_ le^o_ni&s qva_li^s [au]di&to_ te^ne&r 	^^_^_X_^_X_^X	1.0
Timidum iuuencus applicat matri latus,	ti^mi^du&m ju^ve_ncu&s a_ppli^ca&t ma&tri_ la^tu&s 	^^_^_X_^_X_^X	0.98
At ille saeuus matre summota leo	a&t i_lle^ s[ae]vu&s ma_tre^ su_mmo&ta_ le^o& 	X_^_X_^_X_^X	1.0
Praedam minorem morsibus uastis premens	pr[ae]da&m mi^no_re&m mo_rsi^bu&s va&sti&s pre^me&ns 	X_^_X_^_X_^X	1.0
Frangit uehitque: talis e nostro sinu	fra&ngi&t ve^hi_tqve& ta_li^s e_ no&stro_ si^nu& 	X_^_X_^_X_^X	0.87
Te rapiet hostis. oscula et fletus, puer,	te& ra^pi^e^t ho_sti&s o_scu^la& e&t fle&tu&s pu^e&r 	X^^^_X_^_X_^X	1.0
Lacerosque crines excipe et plenus mei	la^ce^ro_sqve^ cri_ne&s e_xci^pe& e&t ple&nu&s me^i& 	^^_^_X_^_X_^X	1.0
Occurre patri; pauca maternae tamen	o&ccu_rre^ pa_tri& p[au]ca^ ma_te&rn[ae] ta^me&n 	X_^_X_^_X_^X	0.46
Perfer querelae uerba: 'si manes habent	pe&rfe&r qve^re_l[ae] ve_rba^ si_ ma&ne_s ha^be&nt 	X_^_X_^_X_^X	1.0
Curas priores nec perit flammis amor,	cu&ra&s pri^o_re&s ne&c pe^ri&t fla&mmi_s a^mo&r 	X_^_X_^_X_^X	1.0
Seruire Graio pateris Andromachen uiro,	se_rui_re^ gra_io& pa^te^ri^s a_ndro^ma^che_n ui^ro&, 	X_^_X^^^_^^_^X	m
Crudelis Hector? lentus et segnis iaces?	cru&de_li^s he_cto&r le_ntu^s e&t se&gni&s ja^ce&s 	X_^_X_^_X_^X	0.93
Redit Achilles.' sume nunc iterum comas	re^di_t a^chi_lle&s.' su_me^ nu&nc i^te^ru&m co^ma&s 	X_^_X_^_^^_^X	m
Et sume lacrimas, quidquid e misero uiri	e&t su_me^ la^cri^ma&s qvi_dqvi^d e_ mi^se^ro_ vi^ri& 	X_^^^X_^_^^_^X	1.0
Funere relictum est, sume quae reddas tuo	fu&ne^re^ re^li_ctu&m e&st su_me^ qv[ae] re&dda&s tu^o& 	X^^^_X_^_X_^X	1.0
Oscula parenti. matris hanc solacio	o&scu^la^ pa^re_nti& ma_tri^s ha&nc so&la_ci^o& 	X^^^_X_^_X_^X	1.0
Relinque uestem: tumulus hanc tetigit meus	re&li_nqve^ ve_ste&m tu^mu^lu^s ha&nc te^ti^gi&t me^u&s 	X_^_X^^^_^^_^X	1.0
Manesque cari. si quid hic cineris latet,	ma&ne_sqve^ ca_ri& si& qvi^d hi&c ci^ne^ri&s la^te&t 	X_^_X_^_^^_^X	1.0
Scrutabor ore. Nullus est flendi modus:	scru&ta_bo^r o_re& nu_llu^s e&st fle&ndi_ mo^du&s 	X_^_X_^_X_^X	1.0
Abripite propere classis Argolicae moram.	a&bri^pi^te^ pro^pe^re& cla_ssi^s a_rgo^li^c[ae] mo^ra&m 	X^^^^^X_^_^^_^X	0.75
Quicumque hymen funestus, inlaetabilis	qvi&cu_mqve& hy^me&n fu&ne_stu^s i_nl[ae]ta_bi^li&s 	X_^_X_^_X_^X	1.0
Lamenta caedes sanguinem gemitus habet,	la&me_nta^ c[ae]de&s sa_ngvi^ne&m ge^mi^tu_s ha^be&t 	X_^_X_^_^^_^X	1.0
Est auspice Helena dignus. euersis quoque	e&st [au]spi^ce& he^le^na& di_gnu^s [eu]e&rsi&s qvo^qve&	X_^^^X_^_X_^X	m
Nocere cogor Phrygibus: ego Pyrrhi toros	no&ce_re^ co_go&r phry^gi^bu^s e^go^ py&rrhi_ to^ro&s 	X_^_X^^^^^X_^X	1.0
Narrare falsos iubeor, ego cultus dare	na&rra_re^ fa_lso&s ju^be^o^r e^go^ cu&ltu&s da^re& 	X_^_X^^^^^X_^X	1.0
Habitusque Graios. arte capietur mea	ha^bi^tu_sqve^ gra_jo&s a_rte^ ca^pi^e&tu&r me^a& 	^^_^_X_^^^X_^X	0.97
Meaque fraude concidet Paridis soror.	me&a_qve^ fr[au]de& co_nci^de&t pa^ri^di&s so^ro&r 	X_^_X_^_^^_^X	1.0
Fallatur; ipsi leuius hoc equidem reor:	fa&lla_tu^r i_psi& le^vi^u^s ho_c e^qvi^de&m re^o&r 	X_^_X^^^_^^_^X	1.0
Optanda mors est sine metu mortis mori.	o&pta_nda^ mo&rs e&st si^ne^ me^tu_ mo&rti&s mo^ri& 	X_^_X^^^_X_^X	1.0
Quid iussa cessas agere? ad auctorem redit	qvi&d ju_ssa^ ce_ssa&s a^ge^re& a^d [au]cto&re&m re^di&t 	X_^_X^^^_X_^X	1.0
Sceleris coacti culpa. - Dardaniae domus	sce^le^ri&s co^a_cti& cu_lpa^ da_rda^ni^[ae] do^mu&s 	^^_^_X_^_^^_^X	1.0
Generosa uirgo, melior afflictos deus	ge^ne^ro_sa^ vi_rgo& me^li^o^r a_ffli&cto&s de^u&s 	^^_^_X^^^_X_^X	1.0
Respicere coepit teque felici parat	re&spi^ce^re^ c[oe]pi&t te_qve^ fe_li&ci_ pa^ra&t 	X^^^_X_^_X_^X	1.0
Dotare thalamo; tale coniugium tibi	do&ta_re^ tha^la^mo& ta_le^ co_nju^gi^u&m ti^bi& 	X_^^^X_^_^^_^X	1.0
Non ipsa sospes Troia, non Priamus daret.	no&n i_psa^ so_spe&s tro_ja^ no&n pri^a^mu&s da^re&t 	X_^_X_^_^^_^X	0.68
Nam te Pelasgae maximum gentis decus,	na&m te_ pe^la_sg[ae] ma_xi^mu&m ge&nti&s de^cu&s 	X_^_X_^_X_^X	1.0
Cui regna campi lata Thessalici patent,	cu&j re_gna^ ca_mpi& la_ta^ the_ssa^li^ci_ pa^te&nt 	X_^_X_^_^^_^X	1.0
Ad sancta lecti iura legitimi petit.	a&d sa_ncta^ le_cti& ju_ra^ le_gi^ti^mi_ pe^ti&t	X_^_X_^_^^_^X	m
Te magna Tethys teque tot pelagi deae	te& ma_gna^ te_thy&s te_qve^ to&t pe^la^gi_ de^[ae] 	X_^_X_^_^^_^X	1.0
Placidumque numen aequoris tumidi Thetis	pla^ci^du_mqve^ nu_me&n [ae]qvo^ri&s tu^mi^di_ the^ti&s 	^^_^_X_^_^^_^X	1.0
Suam uocabunt, te datam Pyrrho socer	su&a&m vo^ca_bu&nt te_ da^ta&m py&rrho_ so^ce&r 	X_^_X_^_X_^X	1.0
Peleus nurum uocabit et Nereus nurum.	pe&l[eu]s nu^ru&m vo&ca_bi^t e&t ne&r[eu]s nu^ru&m 	X_^_X_^_X_^X	1.0
Depone cultus squalidos, festos cape,	de&po_ne^ cu_ltu&s sqva_li^do&s fe&sto&s ca^pe& 	X_^_X_^_X_^X	1.0
Dedisce captam; deprime horrentis comas	de&di_sce^ ca_pta&m de_pri^me& ho_rre&nti&s co^ma&s 	X_^_X_^_X_^X	1.0
Crinemque docta patere distingui manu.	cri&ne_mqve^ do_cta& pa^te^re^ di_sti&ng[ui] ma^nu&	X_^_X^^^_X_^X	m
Hic forsitan te casus excelso magis	hi&c fo_rsi^ta&n te& ca_su^s e_xce&lso_ ma^gi&s 	X_^_X_^_X_^X	0.39
Solio reponet. profuit multis capi.	so^li^o_ re^po_ne&t pro_fu^i&t mu&lti&s ca^pi& 	^^_^_X_^_X_^X	1.0
Hoc derat unum Phrygibus euersis malum,	ho&c de_ra^t u_nu&m phry^gi^bu^s [eu]e&rsi&s ma^lu&m 	X_^_X^^^_X_^X	0.72
Gaudere - flagrant strata passim Pergama:	g[au]de_re^ fla_gra&nt stra_ta^ pa_ssi&m pe_rga^ma& 	X_^_X_^_X_^X	1.0
O coniugale tempus! an quisquam audeat	o& co_nju^ga_le& te_mpu^s a&n qvi&sqva&m [au]de^a&t 	X_^_X_^_X_^X	1.0
Negare? quisquam dubius ad thalamos eat,	ne&ga_re^ qvi_sqva&m du^bi^u^s a&d tha^la^mo_s e^a&t 	X_^_X^^^_^^_^X	1.0
Quos Helena suadet? pestis exitium lues	qvo&s he^le^na^ sva_de&t pe_sti^s e_xi^ti^u&m lu^e&s 	X^^^_X_^_^^_^X	1.0
Vtriusque populi, cernis hos tumulos ducum	u^tri^u_sqve^ po^pu^li& ce_rni^s ho&s tu^mu^lo&s du^cu&m 	^^_^^^X_^_^^_^X	1.0
Et nuda totis ossa quae passim iacent	e&t nu_da^ to_ti&s o_ssa^ qv[ae] pa&ssi&m ja^ce&nt 	X_^_X_^_X_^X	1.0
Inhumata campis? haec hymen sparsit tuus.	i^nhu^ma_ta^ ca_mpi&s h[ae]c hy^me&n spa&rsi&t tu^u&s 	^^_^_X_^_X_^X	1.0
Tibi fluxit Asiae, fluxit Europae cruor,	ti^bi^ flu_xi^t a^si^[ae] flu_xi^t [eu]ro&p[ae] cru^o&r 	^^_^^^X_^_X_^X	0.85
Cum dimicantes lenta prospiceres uiros,	cu&m di_mi^ca_nte&s le_nta^ pro_spi^ce^re&s vi^ro&s 	X_^_X_^_^^_^X	1.0
Incerta uoti - perge, thalamos appara.	i&nce_rta^ vo_ti& pe_rge^ tha^la^mo&s a_ppa^ra& 	X_^_X_^^^X_^X	1.0
Taedis quid opus est quidue sollemni face?	t[ae]di&s qvi^d o^pu^s e&st qvi_dve^ so_lle&mni_ fa^ce& 	X_^^^X_^_X_^X	1.0
Quid igne? thalamis Troia praelucet nouis.	qvi&d i_gne^ tha^la^mi&s tro_ja^ pr[ae]lu&ce_t no^vi&s 	X_^^^X_^_X_^X	0.68
Celebrate Pyrrhi, Troades, conubia,	ce^le^bra_te^ py_rrhi& tro_a^de&s co&nu_bi^a& 	^^_^_X_^_X_^X	0.85
Celebrate digne: planctus et gemitus sonet.	ce^le^bra_te^ di_gne& pla_nctu^s e&t ge^mi^tu&s so^ne&t.	^^_^_X_^_^^_^X	m
Ratione quamuis careat et flecti neget	ra^ti^o_ne^ qva_mvi&s ca^re^a^t e&t fle&cti_ ne^ge&t 	^^_^_X^^^_X_^X	1.0
Magnus dolor sociosque nonnumquam sui	ma&gnu&s do^lo&r so^ci^o_sqve^ no_nnu&mqva_m su^i& 	X_^_^^_^_X_^X	1.0
Maeroris ipsos oderit, causam tamen	m[ae]ro_ri^s i_pso&s o_de^ri&t c[au]sa&m ta^me&n 	X_^_X_^_X_^X	1.0
Possum tueri iudice infesto meam,	po&ssu&m tu^e_ri& ju_di^ce& i_nfe&sto_ me^a&m 	X_^_X_^_X_^X	1.0
Grauiora passa. luget Andromacha Hectorem	gra^vi^o_ra^ pa_ssa& lu_ge^t a_ndro^ma^cha& he_cto^re&m 	^^_^_X_^_^^_^X	1.0
Et Hecuba Priamum: solus occulte Paris	e&t he^cu^ba^ pri^a^mu&m so_lu^s o_ccu&lte_ pa^ri&s 	X^^^^^X_^_X_^X	1.0
Lugendus Helenae est. durum et inuisum et graue est	lu&ge_ndu^s he^le^n[ae] e&st du_ru&m e^t i_nvi&su&m e&t gra^ve& e&st 	X_^^^X_^_X_^X	1.0
Seruitia ferre? patior hoc olim iugum,	se&rvi^ti^a^ fe_rre& pa^ti^o^r ho_c o&li&m ju^gu&m 	X^^^_X^^^_X_^X	1.0
Annis decem captiua. prostratum Ilium est,	a&nni&s de^ce&m ca&pti_va^ pro_stra&tu&m i_li^u&m e&st 	X_^_X_^_X_^X	1.0
Versi penates? perdere est patriam graue,	ve&rsi_ pe^na_te&s pe_rde^re& e&st pa^tri^a&m gra^ve& 	X_^_X_^_^^_^X	1.0
Grauius timere. uos leuat tantus mali	gra^vi^u&s ti^me_re& vo&s le^va&t ta&ntu&s ma^li& 	^^_^_X_^_X_^X	0.82
Comitatus: in me uictor et uictus furit.	co^mi^ta_tu^s i&n me& vi_cto^r e&t vi&ctu&s fu^ri&t 	^^_^_X_^_X_^X	1.0
Quam quisque famulam traheret incerto diu	qva&m qvi_sqve^ fa^mu^la&m tra^he^re^t i_nce&rto_ di^u& 	X_^^^X^^^_X_^X	1.0
Casu pependit? me meus traxit statim	ca&su_ pe^pe_ndi&t me_ me^u&s tra&xi&t sta^ti&m 	X_^_X_^_X_^X	1.0
Sine sorte dominus. causa bellorum fui	si^ne^ so_rte^ do^mi^nu&s c[au]sa^ be_llo&ru&m fu^i& 	^^_^^^X_^_X_^X	1.0
Tantaeque Teucris cladis? hoc uerum puta,	ta&nt[ae]qve^ t[eu]cri&s cla_di^s ho&c ve&ru&m pu^ta& 	X_^_X_^_X_^X	1.0
Spartana puppis uestra si secuit freta;	spa&rta_na^ pu_ppi&s ve_stra^ si_ se^cu^i&t fre^ta& 	X_^_X_^_^^_^X	0.94
Sin rapta Phrygiis praeda remigibus fui	si&n ra_pta^ phry^gi^i&s pr[ae]da^ re_mi^gi^bu&s fu^i& 	X_^^^X_^_^^_^X	1.0
Deditque donum iudici uictrix dea,	de&di_tqve^ do_nu&m ju_di^ci_ vi&ctri&x de^a& 	X_^_X_^_X_^X	1.0
Ignosce † Paridi: iudicem iratum mea	i&gno_sce^ pa^ri^di& ju_di^ce&m i_ra&tu&m me^a&	X_^^^X_^_X_^X	m
Habitura causa est: ista Menelaum manent	ha^bi^tu_ra^ c[au]sa& e&st i_sta^ me^ne^la&u&m ma^ne&nt 	^^_^_X_^^^X_^X	0.97
Arbitria. Nunc hanc luctibus paulum tuis,	a&rbi^tri^a^ nu&nc ha&nc lu_cti^bu&s p[au]lu&m tu^i&s 	X^^^_X_^_X_^X	1.0
Andromacha, omissis flecte - uix lacrimas queo	a&ndro^ma^cha& o^mi_ssi&s fle_cte^ vi&x la^cri^ma&s qve^o& 	X^^^_X_^_^^_^X	1.0
Retinere. Quantum est Helena quod lacrimat malum!	re^ti^ne_re^ qva_ntu&m e&st he^le^na^ qvo&d la^cri^ma&t ma^lu&m	^^_^_X^^^_^^_^X	m
Cur lacrimat autem? fare quos Ithacus dolos,	cu&r la^cri^ma^t [au]te&m fa_re^ qvo_s i^tha^cu&s do^lo&s 	X^^^_X_^_^^_^X	1.0
Quae scelera nectat; utrum ab Idaeis iugis	qv[ae] sce^le^ra^ ne_cta&t u_tru&m a^b i_d[ae]i&s ju^gi&s 	X^^^_X_^_X_^X	0.5
Iactanda uirgo est, arcis an celsae edito	ja&cta_nda^ vi_rgo& e&st a_rci^s a&n ce&ls[ae] e_di^to& 	X_^_X_^_X_^X	1.0
Mittenda saxo? num per has uastum in mare	mi&tte_nda^ sa_xo& nu&m pe^r ha&s va&stu&m i&n ma^re& 	X_^_X_^_X_^X	1.0
Voluenda rupes, latere quas scisso leuat	vo&lve_nda^ ru_pe&s la^te^re^ qva&s sci&sso_ le^va&t 	X_^_X^^^_X_^X	0.86
Altum uadoso Sigeon spectans sinu?	a&ltu&m va^do_so& si_ge^o_n spe&cta&ns si^nu& 	X_^_X_^_X_^X	1.0
Dic, fare, quidquid subdolo uultu tegis.	di&c fa_re^ qvi_dqvi&d su_bdo^lo_ vu&ltu_ te^gi&s 	X_^_X_^_X_^X	1.0
Leuiora mala sunt cuncta, quam Priami gener	le^vi^o_ra^ ma^la^ su&nt cu_ncta^ qva&m pri^a^mi_ ge^ne&r 	^^_^^^X_^_^^_^X	0.94
Hecubaeque Pyrrhus. fare, quam poenam pares	he^cu^b[ae]qve^ py_rrhu&s fa_re^ qva&m p[oe]na&m pa^re&s 	^^_^_X_^_X_^X	1.0
Exprome et unum hoc deme nostris cladibus,	e&xpro_me& e^t u_nu&m ho&c de_me^ no_stri&s cla_di^bu&s 	X_^_X_^_X_^X	1.0
Falli: paratas perpeti mortem uides.	fa&lli_ pa^ra_ta&s pe_rpe^ti_ mo&rte&m vi^de&s 	X_^_X_^_X_^X	1.0
Vtinam iuberet me quoque interpres deum	u^ti^na&m ju^be_re&t me& qvo^qve& i_nte&rpre&s de^u&m 	^^_^_X_^_X_^X	0.93
Abrumpere ense lucis inuisae moras	a&bru_mpe^re& e_nse& lu_ci^s i_nvi&s[ae] mo^ra&s 	X_^_X_^_X_^X	0.97
Vel Achillis ante busta furibunda manu	ve^l a^chi_lli^s a_nte& bu_sta^ fu^ri^bu&nda_ ma^nu& 	^^_^_X_^^^X_^X	1.0
Occidere Pyrrhi, fata comitantem tua,	o&cci^de^re^ py_rrhi& fa_ta^ co^mi^ta&nte&m tu^a& 	X^^^_X_^^^X_^X	1.0
Polyxene miseranda, quam tradi sibi	po&ly_xe^ne_ mi^se^ra_nda^ qva&m tra&di_ si^bi&	X_^_^^_^_X_^X	m
Cineremque Achilles ante mactari suum,	ci^ne^re_mqve& a^chi_lle&s a_nte^ ma_cta&ri& su^u&m 	^^_^_X_^_X_^X	1.0
Campo maritus ut sit Elysio, iubet.	ca&mpo_ ma^ri_tu&s u&t si^t e_ly^si^o_ ju^be&t 	X_^_X_^_^^_^X	1.0
Vide ut animus ingens laetus audierit necem.	vi^de& u^t a^ni^mu^s i_nge&ns l[ae]tu^s [au]di^e^ri&t ne^ce&m 	^^^^^_X_^_^^_^X	1.0
Cultus decoros regiae uestis petit	cu&ltu&s de^co_ro&s re_gi^[ae] ve&sti&s pe^ti&t 	X_^_X_^_X_^X	1.0
Et admoueri crinibus patitur manum:	e&t a_dmo^ve_ri& cri_ni^bu&s pa^ti^tu&r ma^nu&m 	X_^_X_^_^^_^X	1.0
Mortem putabat illud, hoc thalamos putat.	mo&rte&m pu^ta_ba&t i_llu^d ho&c tha^la^mo&s pu^ta&t 	X_^_X_^_^^_^X	1.0
At misera luctu mater audito stupet;	a&t mi^se^ra^ lu_ctu& ma_te^r [au]di&to& stu^pe&t 	X^^^_X_^_X_^X	1.0
Labefacta mens succubuit - assurge, alleua	la^be^fa_cta^ me&ns su&ccu^bu^i^t a_ssu&rge& a_lle^va& 	^^_^_X^^^_X_^X	1.0
Animum et cadentem, misera, firma spiritum.	a^ni^mu&m e&t ca^de_nte&m mi^se^ra^ fi_rma& spi_ri^tu&m 	^^_^_X^^^_X_^X	1.0
Quam tenuis anima uinculo pendet leui:	qva&m te^nu^i^s a^ni^ma& vi_ncu^lo_ pe_nde&t le^vi&	X^^^^^X_^_X_^X	m
Minimum est quod Hecubam facere felicem potest -	mi^ni^mu&m e&st qvo^d he^cu^ba&m fa^ce^re^ fe_li&ce&m po^te&st 	^^_^^^X^^^_X_^X	1.0
Spirat, reuixit. prima mors miseros fugit.	spi&ra&t re^vi_xi&t pri_ma^ mo&rs mi^se^ro&s fu^gi&t 	X_^_X_^_^^_^X	0.76
Adhuc Achilles uiuit in poenas Phrygum?	a&dhu_c a^chi_lle&s vi_vi^t i&n p[oe]na&s phry^gu&m 	X_^_X_^_X_^X	1.0
Adhuc rebellat? o manum Paridis leuem.	a&dhu&c re^be_lla&t o_ ma^nu&m pa^ri^di&s le^ve&m 	X_^_X_^_^^_^X	0.93
Cinis ipse nostrum sanguinem ac tumulus sitit.	ci^ni^s i_pse^ no_stru&m sa_ngvi^ne&m a&c tu^mu^lu&s si^ti&t 	^^_^_X_^_^^_^X	1.0
Modo turba felix latera cingebat mea,	mo^do^ tu_rba^ fe_li&x la^te^ra^ ci_nge&ba&t me^a& 	^^_^_X^^^_X_^X	0.95
Lassabar in tot oscula et tantum gregem	la&ssa_ba^r i&n to&t o_scu^la& e&t ta&ntu&m gre^ge&m 	X_^_X_^_X_^X	1.0
Diuidere matrem; sola nunc haec est super,	di&vi^de^re^ ma_tre&m so_la^ nu&nc h[ae]c e&st su^pe&r 	X^^^_X_^_X_^X	0.97
Votum, comes, leuamen afflictae, quies;	vo&tu&m co^me&s le&va_me^n a_ffli&ctae& qvi^e&s 	X_^_X_^_X_^X	1.0
Haec totus Hecubae fetus, hac sola uocor	h[ae]c to_tu^s he^cu^b[ae] fe_tu^s ha&c so&la_ vo^co&r 	X_^^^X_^_X_^X	0.12
Iam uoce mater. dura et infelix age	ja&m vo_ce^ ma_te&r du_ra& e^t i_nfe&li&x a^ge& 	X_^_X_^_X_^X	1.0
Elabere anima, denique hoc unum mihi	e_la_be^re& a^ni^ma&, de_ni^que& ho_c u_nu&m mi^hi& 	X_^^^X_^_X_^X	m
Remitte funus - inrigat fletus genas	re&mi_tte^ fu_nu&s i_nri^ga&t fle&tu&s ge^na&s 	X_^_X_^_X_^X	1.0
Imberque uicto subitus e uultu cadit:	i&mbe_rqve^ vi_cto& su^bi^tu^s e_ vu&ltu_ ca^di&t 	X_^_X^^^_X_^X	1.0
Laetare, gaude, nata. quam uellet tuos	l[ae]ta_re^ g[au]de& na_ta^ qva&m ve&lle&t tu^o&s 	X_^_X_^_X_^X	1.0
Cassandra thalamos, uellet Andromache tuos!	ca&ssa_ndra^ tha^la^mo&s ve_lle^t a_ndro^ma^che_ tu^o&s 	X_^^^X_^_^^_^X	1.0
Nos, Hecuba, nos, nos, Hecuba, lugendae sumus,	no&s he^cu^ba^ no&s no&s he^cu^ba^ lu_ge&nd[ae] su^mu&s 	X^^^_X^^^_X_^X	1.0
Quas mota classis huc et huc sparsas feret;	qva&s mo_ta^ cla_ssi&s hu_c e^t hu&c spa&rsa&s fe^re&t 	X_^_X_^_X_^X	1.0
Hanc cara tellus sedibus patriis teget.	ha&nc ca_ra^ te_llu&s se_di^bu&s pa^tri^i&s te^ge&t 	X_^_X_^_^^_^X	1.0
Magis inuidebis, si tuam sortem scies.	ma^gi^s i_nui^de_bi&s, si_ tu^a&m so_rte&m sci^e&s. 	^^_^_X_^_X_^X	m
An aliqua poenae pars meae ignota est mihi?	a&n a^li^qva^ p[oe]n[ae] pa&rs me^[ae] i_gno&ta& e&st mi^hi& 	X^^^_X_^_X_^X	1.0
Versata dominos urna captiuis dedit.	ve&rsa_ta^ do^mi^no&s u_rna^ ca_pti&vi&s de^di&t 	X_^^^X_^_X_^X	1.0
Cui famula trador? ede: quem dominum uoco?	c[ui] fa^mu^la^ tra_do&r e_de^ qve&m do^mi^nu&m vo^co&	X^^^_X_^_^^_^X	v
Te sorte prima Scyrius iuuenis tulit.	te& so_rte^ pri_ma& scy_ri^u_s ju^ve^ni&s tu^li&t 	X_^_X_^_^^_^X	1.0
Cassandra felix, quam furor sorti eximit	ca&ssa_ndra^ fe_li&x qva&m fu^ro&r so&rti& e_xi^mi&t 	X_^_X_^_X_^X	1.0
Phoebusque. Regum hanc maximus rector tenet.	ph[oe]bu_sqve^ re_gu&m ha&nc ma_xi^mu&s re&cto&r te^ne&t 	X_^_X_^_X_^X	1.0
Estne aliquis, Hecubam qui suam dici uelit?	e&stne& a^li^qvi^s he^cu^ba&m qvi& su^a&m di&ci_ ve^li&t 	X^^^^^X_^_X_^X	1.0
Ithaco obtigisti praeda nolenti breuis.	i^tha^co& o_bti^gi_sti& pr[ae]da^ no_le&nti& bre^vi&s 	^^_^_X_^_X_^X	1.0
Quis tam impotens ac durus et iniquae ferus	qvi&s ta&m i_mpo^te_ns a&c du_ru^s e^t i^ni&qv[ae] fe^ru&s 	X_^_X_^^^X_^X	1.0
Sortitor urnae regibus reges dedit?	so&rti_to^r u_rn[ae] re_gi^bu&s re&ge&s de^di&t 	X_^_X_^_X_^X	1.0
Quis tam sinister diuidit captas deus?	qvi&s ta&m si^ni_ste&r di_vi^di&t ca&pta&s de^u&s 	X_^_X_^_X_^X	1.0
Quis arbiter crudelis et miseris grauis	qvi&s a_rbi^te&r cru&de_li^s e&t mi^se^ri&s gra^vi&s 	X_^_X_^_^^_^X	0.92
Eligere dominos nescit et saeua manu	e&li^ge^re^ do^mi^no&s ne_sci^t e&t s[ae]va_ ma^nu& 	X^^^^^X_^_X_^X	1.0
Dat iniqua miseris fata? quis matrem Hectoris	da^t i^ni_qva^ mi^se^ri&s fa_ta^ qvi&s ma&tre&m he_cto^ri&s 	^^_^^^X_^_X_^X	0.98
Armis Achillis miscet? ad Vlixem uocor:	a&rmi_s a^chi_lli&s mi_sce^t a^d u^li&xe_m vo^co&r 	X_^_X_^^^X_^X	1.0
Nunc uicta, nunc captiua, nunc cunctis mihi	nu&nc vi_cta^ nu&nc ca&pti_va^ nu&nc cu&ncti&s mi^hi& 	X_^_X_^_X_^X	1.0
Obsessa uideor cladibus: domini pudet,	o&bse_ssa^ vi^de^o&r cla_di^bu&s do^mi^ni_ pu^de&t 	X_^^^X_^_^^_^X	1.0
Non seruitutis. Hectoris spolium feret	no&n se_rvi^tu_ti&s he_cto^ri&s spo^li^u&m fe^re&t 	X_^_X_^_^^_^X	1.0
Qui tulit Achillis? sterilis et saeuis fretis	qui_ tu^li^t a^chi_lli&s? ste^ri^li^s e&t s[ae]ui&s fre^ti&s 	X^^^_X^^^_X_^X	m
Inclusa tellus non capit tumulos meos.	i&nclu_sa^ te_llu&s no&n ca^pi&t tu^mu^lo&s me^o&s 	X_^_X_^_^^_^X	1.0
Duc, duc, Vlixe, nil moror, dominum sequor;	du&c du_c u^li_xe& ni&l mo^ro&r do^mi^nu&m se^qvo&r 	X_^_X_^_^^_^X	1.0
Me mea sequentur fata (non pelago quies	me& me^a^ se^qve_ntu&r fa_ta^ no&n pe^la^go& qvi^e&s 	X^^^_X_^_^^_^X	1.0
Tranquilla ueniet, saeuiet uentis mare)	tra&nqvi_lla^ ve^ni^e&t s[ae]vi^e&t ve&nti&s ma^re& 	X_^^^X_^_X_^X	1.0
Et bella et ignes et mea et Priami mala.	e&t be_lla& e^t i_gne&s e&t me^a& e&t pri^a^mi_ ma^la& 	X_^_X_^_^^_^X	0.94
Dumque ista ueniant, interim hoc poenae loco est:	du&mqve& i_sta^ ve^ni^a&nt i_nte^ri&m ho&c p[oe]n[ae] lo^co& e&st 	X_^^^X_^_X_^X	1.0
Sortem occupaui, praemium eripui tibi.	so&rte&m o_ccu^pa_vi& pr[ae]mi^u&m e_ri^pu^i_ ti^bi& 	X_^_X_^_^^_^X	1.0
Sed incitato Pyrrhus accurrit gradu	se&d i_nci^ta_to& py_rrhu^s a_ccu&rri&t gra^du& 	X_^_X_^_X_^X	1.0
Vultuque toruo. Pyrrhe, quid cessas? age	vu&ltu_qve^ to_rvo& py_rrhe^ qvi&d ce&ssa_s a^ge& 	X_^_X_^_X_^X	1.0
Reclude ferro pectus et Achillis tui	re&clu_de^ fe_rro& pe_ctu^s e^t a^chi&lli&s tu^i& 	X_^_X_^^^X_^X	1.0
Coniunge soceros. perge, mactator senum,	co&nju_nge^ so^ce^ro&s pe_rge^ ma_cta&to_r se^nu&m 	X_^^^X_^_X_^X	1.0
Et hic decet te sanguis - abreptam trahit.	e&t hi&c de^ce&t te& sa_ngvi^s a_bre&pta&m tra^hi&t 	X_^_X_^_X_^X	0.76
Maculate superos caede funesta deos,	ma^cu^la_te^ su^pe^ro&s c[ae]de^ fu_ne&sta_ de^o&s	^^_^^^X_^_X_^X	m
Maculate manes - quid precer uobis? precor	ma^cu^la_te^ ma_ne&s qvi&d pre^ce&r vo&bi&s pre^co&r	^^_^_X_^_X_^X	m
His digna sacris aequora: hoc classi accidat	hi&s di_gna^ sa_cri&s [ae]qvo^ra& ho&c cla&ssi& a_cci^da&t 	X_^_X_^_X_^X	0.88
Toti Pelasgae, ratibus hoc mille accidat	to&ti_ pe^la_sg[ae] ra^ti^bu^s ho&c mi&lle& a_cci^da&t 	X_^_X^^^_X_^X	1.0
Meae precabor, cum uehar, quidquid rati.	me&[ae] pre^ca_bo&r cu&m ve^ha&r qvi&dqvi&d ra^ti& 	X_^_X_^_X_^X	1.0
O dura fata, saeua miseranda horrida!	o& du_ra^ fa_ta& s[ae]va^ mi^se^ra&nda& ho_rri^da& 	X_^_X_^^^X_^X	1.0
Quod tam ferum, tam triste bis quinis scelus	qvo&d ta&m fe^ru&m ta&m tri_ste^ bi&s qvi&ni&s sce^lu&s 	X_^_X_^_X_^X	1.0
Mars uidit annis? quid prius referens gemam,	ma&rs vi_di^t a_nni&s qvi&d pri^u&s re^fe^re&ns ge^ma&m 	X_^_X_^_^^_^X	1.0
Tuosne potius, an tuos luctus, anus?	tu&o_sne^ po^ti^u&s a&n tu^o&s lu&ctu_s a^nu&s 	X_^^^X_^_X_^X	0.43
Quoscumque luctus fleueris, flebis meos:	qvo&scu_mqve^ lu_ctu&s fl[eu]e^ri&s fle&bi&s me^o&s 	X_^_X_^_X_^X	1.0
Sua quemque tantum, me omnium clades premit;	su^a^ qve_mqve^ ta_ntu&m me& o_mni^u&m cla&de&s pre^mi&t 	^^_^_X_^_X_^X	1.0
Mihi cuncta pereunt: quisquis est Hecubae est miser.	mi^hi^ cu_ncta^ pe^re^u&nt qvi_sqvi^s e&st he^cu^b[ae] e&st mi^se&r 	^^_^^^X_^_^^_^X	0.81
Mactata uirgo est, missus e muris puer;	ma&cta_ta^ vi_rgo& e&st mi_ssu^s e_ mu&ri&s pu^e&r 	X_^_X_^_X_^X	1.0
Sed uterque letum mente generosa tulit.	se^d u^te_rqve^ le_tu&m me_nte^ ge^ne^ro&sa_ tu^li&t 	^^_^_X_^^^X_^X	1.0
Expone seriem caedis, et duplex nefas	e&xpo_ne^ se^ri^e&m c[ae]di^s e&t du&ple&x ne^fa&s 	X_^^^X_^_X_^X	1.0
Persequere: gaudet magnus aerumnas dolor	pe&rse^qve^re^ g[au]de&t ma_gnu^s [ae]ru&mna_s do^lo&r 	X^^^_X_^_X_^X	1.0
Tractare totas. ede et enarra omnia.	tra&cta_re^ to_ta&s e_de& e^t e_na&rra& o_mni^a& 	X_^_X_^_X_^X	1.0
Est una magna turris e Troia super,	e&st u_na^ ma_gna& tu_rri^s e& tro&ja_ su^pe&r	X_^_X_^_X_^X	m
Assueta Priamo, cuius e fastigio	a&ssve_ta^ pri^a^mo& cu_ju^s e_ fa&sti_gi^o& 	X_^^^X_^_X_^X	1.0
Summisque pinnis arbiter belli sedens	su&mmi_sqve^ pi_nni&s a_rbi^te&r be&lli_ se^de&ns 	X_^_X_^_X_^X	1.0
Regebat acies. turre in hac blando sinu	re&ge_ba^t a^ci^e&s tu_rre& i^n ha&c bla&ndo_ si^nu& 	X_^^^X_^_X_^X	1.0
Fouens nepotem, cum metu uersos graui	fo&ve&ns ne^po_te&m cu&m me^tu_ ve&rso&s gra^vi& 	X_^_X_^_X_^X	1.0
Danaos fugaret Hector et ferro et face,	da^na^o&s fu^ga_re&t he_cto^r e&t fe&rro& e&t fa^ce& 	^^_^_X_^_X_^X	1.0
Paterna puero bella monstrabat senex.	pa&te_rna^ pu^e^ro& be_lla^ mo_nstra&ba&t se^ne&x 	X_^^^X_^_X_^X	1.0
Haec nota quondam turris et muri decus,	h[ae]c no_ta^ qvo_nda&m tu_rri^s e&t mu&ri_ de^cu&s 	X_^_X_^_X_^X	0.48
Nunc saeua cautes, undique adfusa ducum	nu&nc s[ae]va^ c[au]te&s u_ndi^qve& a_dfu&sa_ du^cu&m 	X_^_X_^_X_^X	1.0
Plebisque turba cingitur; totum coit	ple&bi_sqve^ tu_rba& ci_ngi^tu&r to&tu&m co^i&t 	X_^_X_^_X_^X	1.0
Ratibus relictis uulgus. his collis procul	ra^ti^bu&s re^li_cti&s vu_lgu^s hi&s co&lli&s pro^cu&l 	^^_^_X_^_X_^X	1.0
Aciem patenti liberam praebet loco,	a^ci^e&m pa^te_nti& li_be^ra_m pr[ae]be&t lo^co& 	^^_^_X_^_X_^X	1.0
His alta rupes, cuius in fastigio	hi&s a_lta^ ru_pe&s cu_ju^s i&n fa&sti_gi^o& 	X_^_X_^_X_^X	1.0
Erecta summos turba librauit pedes.	e&re_cta^ su_mmo&s tu_rba^ li_br[au]i&t pe^de&s 	X_^_X_^_X_^X	1.0
Hunc pinus, illum laurus, hunc fagus gerit	hu&nc pi_nu^s i_llu&m l[au]ru^s hu&nc fa&gu&s ge^ri&t 	X_^_X_^_X_^X	0.42
Et tota populo silua suspenso tremit.	e&t to_ta^ po^pu^lo& si_lva^ su_spe&nso& tre^mi&t 	X_^^^X_^_X_^X	1.0
Extrema montis ille praerupti petit,	e&xtre_ma^ mo_nti&s i_lle^ pr[ae]ru&pti_ pe^ti&t 	X_^_X_^_X_^X	1.0
Semusta at ille tecta uel saxum imminens	se&mu_sta& a^t i_lle& te_cta^ ve&l sa&xu&m i_mmi^ne&ns 	X_^_X_^_X_^X	1.0
Muri cadentis pressit, atque aliquis (nefas)	mu&ri_ ca^de_nti&s pre_ssi^t a_tqve& a^li^qvi&s ne^fa&s 	X_^_X_^_^^_^X	1.0
Tumulo ferus spectator Hectoreo sedet.	tu^mu^lo_ fe^ru&s spe&cta_to^r he_cto^re^o_ se^de&t 	^^_^_X_^_^^_^X	1.0
Per spatia late plena sublimi gradu	pe&r spa^ti^a^ la_te& ple_na^ su_bli&mi& gra^du& 	X^^^_X_^_X_^X	0.98
Incedit Ithacus paruulum dextra trahens	i&nce_di^t i^tha^cu&s pa_rvu^lu_m de&xtra_ tra^he&ns 	X_^^^X_^_X_^X	1.0
Priami nepotem, nec gradu segni puer	pri^a^mi_ ne^po_te&m ne&c gra^du_ se&gni_ pu^e&r 	^^_^_X_^_X_^X	1.0
Ad alta pergit moenia. ut summa stetit	a&d a_lta^ pe_rgi&t m[oe]ni^a& u&t su&mma& ste^ti&t 	X_^_X_^_X_^X	1.0
Pro turre, uultus huc et huc acres tulit	pro& tu_rre^ vu_ltu&s hu_c e^t hu_c a&cre&s tu^li&t 	X_^_X_^_X_^X	1.0
Intrepidus animo. qualis ingentis ferae	i&ntre^pi^du^s a^ni^mo& qva_li^s i_nge&nti&s fe^r[ae] 	X^^^^^X_^_X_^X	1.0
Paruus tenerque fetus et nondum potens	pa&rvu&s te^ne_rqve& fe_tu^s e&t no&ndu&m po^te&ns 	X_^_X_^_X_^X	0.12
Saeuire dente iam tamen tollit minas	s[ae]vi_re^ de_nte& ja&m ta^me&n to&lli&t mi^na&s 	X_^_X_^_X_^X	1.0
Morsusque inanes temptat atque animis tumet:	mo&rsu_sqve& i^na_ne&s te_mpta^t a_tqve& a^ni^mi&s tu^me&t 	X_^_X_^_^^_^X	1.0
Sic ille dextra prensus hostili puer	si&c i_lle^ de_xtra& pre_nsu^s ho_sti&li_ pu^e&r 	X_^_X_^_X_^X	1.0
Ferox superbit. mouerat uulgum ac duces	fe&ro&x su^pe_rbi&t mo_ve^ra&t vu&lgu&m a&c du^ce&s 	X_^_X_^_X_^X	1.0
Ipsumque Vlixem. non flet e turba omnium	i&psu_mqve& u^li_xe&m no&n fle^t e_ tu&rba& o_mni^u&m 	X_^_X_^_X_^X	1.0
Qui fletur; ac, dum uerba fatidici et preces	qvi& fle_tu^r a&c du&m ve_rba^ fa_ti^di^ci& e&t pre^ce&s 	X_^_X_^_^^_^X	1.0
Concipit Vlixes uatis et saeuos ciet	co&nci^pi^t u^li_xe&s va_ti^s e&t s[ae]vo&s ci^e&t 	X^^^_X_^_X_^X	1.0
Ad sacra superos, sponte desiluit sua	a&d sa_cra^ su^pe^ro&s spo_nte^ de_si^lu^i&t su^a& 	X_^^^X_^_^^_^X	0.97
Quis Colchus hoc, quis sedis incertae Scytha	qvi&s co_lchu^s ho&c qvi&s se_di^s i_nce&rt[ae] scy^tha& 	X_^_X_^_X_^X	1.0
Commisit, aut quae Caspium tangens mare	co&mmi_si^t [au]t qv[ae] ca_spi^u_m ta&nge&ns ma^re& 	X_^_X_^_X_^X	1.0
Gens iuris expers ausa? non Busiridis	ge&ns ju_ri^s e_xpe&rs [au]sa^ no&n bu&si_ri^di&s 	X_^_X_^_X_^X	1.0
Puerilis aras sanguis aspersit feri,	pu^e^ri_li^s a_ra&s sa_ngvi^s a_spe&rsi&t fe^ri& 	^^_^_X_^_X_^X	0.76
Nec parua gregibus membra Diomedes suis	ne&c pa_rva^ gre^gi^bu&s me_mbra^ di^o^me&de&s su^i&s 	X_^^^X_^^^X_^X	1.0
Epulanda posuit. quis tuos artus teget	e^pu^la_nda^ po^su^i&t qvi&s tu^o_s a&rtu&s te^ge&t 	^^_^^^X_^_X_^X	1.0
Tumuloque tradet? Quos enim praeceps locus	tu^mu^lo_qve^ tra_de&t qvo_s e^ni&m pr[ae]ce&ps lo^cu&s 	^^_^_X_^_X_^X	1.0
Reliquit artus? ossa disiecta et graui	re&li_qvi^t a_rtu&s o_ssa^ di_sje&cta& e&t gra^vi& 	X_^_X_^_X_^X	1.0
Elisa casu; signa clari corporis,	e&li_sa^ ca_su& si_gna^ cla_ri& co_rpo^ri&s 	X_^_X_^_X_^X	1.0
Et ora et illas nobiles patris notas,	e&t o_ra& e^t i_lla&s no_bi^le&s pa&tri&s no^ta&s 	X_^_X_^_X_^X	0.69
Confundit imam pondus ad terram datum;	co&nfu_ndi^t i_ma&m po_ndu^s a&d te&rra&m da^tu&m 	X_^_X_^_X_^X	1.0
Soluta ceruix silicis impulsu, caput	so&lu_ta^ ce_rvi&x si^li^ci^s i_mpu&lsu_ ca^pu&t 	X_^_X^^^_X_^X	1.0
Ruptum cerebro penitus expresso - iacet	ru&ptu&m ce^re_bro& pe^ni^tu^s e_xpre&sso_ ja^ce&t 	X_^_X^^^_X_^X	0.88
Deforme corpus. Sic quoque est similis patri.	de&fo_rme^ co_rpu&s si&c qvo^qve& e&st si^mi^li&s pa^tri& 	X_^_X_^_^^_^X	0.5
Praeceps ut altis cecidit e muris puer	pr[ae]ce&ps u^t a_lti&s ce^ci^di^t e_ mu&ri&s pu^e&r 	X_^_X^^^_X_^X	0.97
Fleuitque Achiuum turba quod fecit nefas,	fl[eu]i_tqve& a^chi_vu&m tu_rba^ qvo&d fe&ci&t ne^fa&s 	X_^_X_^_X_^X	1.0
Idem ille populus aliud ad facinus redit	i&de&m i_lle^ po^pu^lu&s a^li^u^d a&d fa^ci^nu&s re^di&t	X_^^^X^^^_^^_^X	m
Tumulumque Achillis. cuius extremum latus	tu^mu^lu_mqve& a^chi_lli&s cu_ju^s e_xtre&mu&m la^tu&s 	^^_^_X_^_X_^X	0.98
Rhoetea leni uerberant fluctu uada;	rh[oe]te_a^ le_ni_ ue_rbe^ra&nt flu_ctu_ ua^da&; 	X_^_X_^_X_^X	m
Aduersa cingit campus et cliuo leui	a&dve_rsa^ ci_ngi&t ca_mpu^s e&t cli&vo_ le^vi& 	X_^_X_^_X_^X	0.96
Erecta medium uallis includens locum	e&re_cta^ me^di^u&m va_lli^s i_nclu&de_ns lo^cu&m 	X_^^^X_^_X_^X	0.71
Crescit theatri more. concursus frequens	cre&sci&t the^a_tri& mo_re^ co_ncu&rsu&s fre^qve&ns 	X_^_X_^_X_^X	1.0
Impleuit omne litus: hi classis moram	i&mpl[eu]i^t o_mne& li_tu^s hi& cla&ssi&s mo^ra&m 	X_^_X_^_X_^X	1.0
Hac morte solui rentur, hi stirpem hostium	ha&c mo_rte^ so_lvi& re_ntu^r hi& sti&rpe&m ho_sti^u&m 	X_^_X_^_X_^X	1.0
Gaudent recidi. magna pars uulgi leuis	g[au]de&nt re^ci_di& ma_gna^ pa&rs vu&lgi_ le^vi&s 	X_^_X_^_X_^X	0.9
Odit scelus spectatque; nec Troes minus	o&di&t sce^lu&s spe&cta_tqve^ ne&c tro&e&s mi^nu&s 	X_^_X_^_X_^X	1.0
Suum frequentant funus et pauidi metu	su&u&m fre^qve_nta&nt fu_nu^s e&t pa^vi^di_ me^tu& 	X_^_X_^_^^_^X	1.0
Partem ruentis ultimam Troiae uident:	pa&rte&m ru^e_nti&s u_lti^ma&m tro&j[ae] vi^de&nt 	X_^_X_^_X_^X	1.0
Cum subito thalami more praecedunt faces	cu&m su^bi^to^ tha^la^mi_ mo_re^ pr[ae]ce_du&nt fa^ce_s 	X^^^^^X_^_X_^X	m
Et pronuba illi Tyndaris, maestum caput	e&t pro_nu^ba& i_lli& ty_nda^ri&s m[ae]stu&m ca^pu&t 	X_^_X_^_X_^X	1.0
Demissa. 'tali nubat Hermione modo'	de&mi_ssa^ ta_li& nu_ba^t he_rmi^o^ne_ mo^do&	X_^_X_^_^^_^X	m
Phryges precantur, 'sic uiro turpis suo	phry&ge&s pre^ca_ntu&r si&c vi^ro_ tu&rpi&s su^o& 	X_^_X_^_X_^X	1.0
Reddatur Helena.' terror attonitos tenet	re&dda_tu^r he^le^na& te_rro^r a_tto^ni^to&s te^ne&t	X_^^^X_^_^^_^X	m
Vtrosque populos. ipsa deiectos gerit	u&tro_sqve^ po^pu^lo&s i_psa^ d[ei]e&cto&s ge^ri&t 	X_^^^X_^_X_^X	1.0
Vultus pudore, sed tamen fulgent genae	vu&ltu&s pu^do_re& se&d ta^me&n fu&lge&nt ge^n[ae] 	X_^_X_^_X_^X	1.0
Magisque solito splendet extremus decor,	ma&gi_sqve^ so^li^to& sple_nde^t e_xtre&mu&s de^co&r 	X_^^^X_^_X_^X	1.0
Vt esse Phoebi dulcius lumen solet	u&t e_sse^ ph[oe]bi& du_lci^u&s lu&me&n so^le&t 	X_^_X_^_X_^X	1.0
Iamiam cadentis, astra cum repetunt uices	ja&mja&m ca^de_nti&s a_stra^ cu&m re^pe^tu&nt vi^ce&s 	X_^_X_^_^^_^X	1.0
Premiturque dubius nocte uicina dies.	pre^mi^tu_rqve^ du^bi^u&s no_cte^ vi_ci&na_ di^e&s 	^^_^^^X_^_X_^X	1.0
Stupet omne uulgus: et fere cuncti magis	stu^pe^t o_mne^ vu_lgu&s e&t fe^re_ cu&ncti_ ma^gi&s 	^^_^_X_^_X_^X	1.0
Peritura laudant hos mouet formae decus,	pe^ri^tu_ra^ l[au]da&nt ho&s mo^ve&t fo&rm[ae] de^cu&s 	^^_^_X_^_X_^X	1.0
Hos mollis aetas, hos uagae rerum uices;	ho&s mo_lli^s [ae]ta&s ho&s va^g[ae] re&ru&m vi^ce&s 	X_^_X_^_X_^X	0.33
Mouet animus omnes fortis et leto obuius,	mo^ve^t a^ni^mu^s o_mne&s fo_rti^s e&t le&to& o_bvi^u&s 	^^^^^_X_^_X_^X	1.0
Pyrrhum antecedit; omnium mentes tremunt	py&rrhu&m a_nte^ce_di&t o_mni^u&m me&nte&s tre^mu&nt 	X_^_X_^_X_^X	1.0
Mirantur ac miserantur. Vt primum ardui	mi_ra_ntu^r a&c mi^se^ra_ntu^r. v&t pri&mu&m a_rdu^i& 	X_^_^^_^_X_^X	m
Sublime montis tetigit, atque alte edito	su&bli_me^ mo_nti&s te^ti^gi^t a_tqve& a&lte& e_di^to& 	X_^_X^^^_X_^X	1.0
Iuuenis paterni uertice in busti stetit,	ju^ve^ni&s pa^te_rni& ve_rti^ce& i&n bu&sti& ste^ti&t 	^^_^_X_^_X_^X	1.0
Audax uirago non tulit retro gradum;	[au]da&x vi^ra_go& no&n tu^li&t re&tro& gra^du&m 	X_^_X_^_X_^X	1.0
Conuersa ad ictum stat truci uultu ferox.	co&nve_rsa& a^d i_ctu&m sta&t tru^ci_ vu&ltu_ fe^ro&x 	X_^_X_^_X_^X	1.0
Tam fortis animus omnium mentes ferit,	ta&m fo_rti^s a^ni^mu&s o_mni^u&m me&nte&s fe^ri&t 	X_^^^X_^_X_^X	1.0
Nouumque monstrum est Pyrrhus ad caedem piger.	no&vu_mqve^ mo_nstru&m e&st py_rrhu^s a&d c[ae]de&m pi^ge&r 	X_^_X_^_X_^X	1.0
Vt dextra ferrum penitus exactum abdidit,	u&t de_xtra^ fe_rru&m pe^ni^tu^s e_xa&ctu&m a_bdi^di&t 	X_^_X^^^_X_^X	1.0
Subitus recepta morte prorupit cruor	su^bi^tu&s re^ce_pta& mo_rte^ pro_ru&pi&t cru^o&r 	^^_^_X_^_X_^X	1.0
Per uulnus ingens. nec tamen moriens adhuc	pe&r vu_lnu^s i_nge&ns ne&c ta^me&n mo^ri^e&ns a^dhu&c 	X_^_X_^_^^_^X	1.0
Deponit animos: cecidit, ut Achilli grauem	de&po_ni^t a^ni^mo&s ce^ci^di^t u^t a^chi&lli& gra^ve&m 	X_^^^X^^^^^X_^X	0.97
Factura terram, prona et irato impetu.	fa&ctu_ra^ te_rra&m pro_na& e^t i_ra&to& i_mpe^tu& 	X_^_X_^_X_^X	1.0
Vterque fleuit coetus; at timidum Phryges	u&te_rqve^ fl[eu]i&t c[oe]tu^s a&t ti^mi^du&m phry^ge&s 	X_^_X_^_^^_^X	0.4
Misere gemitum, clarius uictor gemit.	mi&se_re^ ge^mi^tu&m cla_ri^u&s vi&cto&r ge^mi&t 	X_^^^X_^_X_^X	0.92
Hic ordo sacri. non stetit fusus cruor	hi&c o_rdo^ sa_cri& no&n ste^ti&t fu&su&s cru^o&r 	X_^_X_^_X_^X	0.89
Humoue summa fluxit: obduxit statim	hu&mo_ve^ su_mma& flu_xi^t o_bdu&xi&t sta^ti&m 	X_^_X_^_X_^X	1.0
Saeuusque totum sanguinem tumulus bibit.	s[ae]vu_sqve^ to_tu&m sa_ngvi^ne&m tu^mu^lu&s bi^bi&t 	X_^_X_^_^^_^X	1.0
Ite, ite, Danai, petite iam tuti domos;	i&te& i_te^ da^na^i& pe^ti^te^ ja&m tu&ti_ do^mo&s 	X_^^^X^^^_X_^X	1.0
Optata uelis maria diffusis secet	o&pta_ta^ ve_li&s ma^ri^a^ di_ffu&si&s se^ce&t 	X_^_X^^^_X_^X	0.55
Secura classis: concidit uirgo ac puer;	se&cu_ra^ cla_ssi&s co_nci^di&t vi&rgo& a&c pu^e&r 	X_^_X_^_X_^X	1.0
Bellum peractum est. quo meas lacrimas feram?	be&llu&m pe^ra_ctu&m e&st qvo_ me^a&s la^cri^ma&s fe^ra&m 	X_^_X_^_^^_^X	1.0
Vbi hanc anilis expuam leti moram?	u&bi& ha&nc a^ni_li&s e_xpu^a_m le&ti_ mo^ra&m 	X_^_X_^_X_^X	1.0
Natam an nepotem, coniugem an patriam fleam?	na&ta&m a&n ne^po_te&m co_nju^ge&m a&n pa^tri^a&m fle^a&m 	X_^_X_^_^^_^X	1.0
An omnia an me? sola mors uotum meum,	a&n o_mni^a& a&n me& so_la^ mo&rs vo&tu&m me^u&m 	X_^_X_^_X_^X	0.97
Infantibus, uiolenta, uirginibus uenis,	i&nfa_nti^bu&s vi^o^le_nta^ vi_rgi^ni^bu&s ve^ni&s	X_^_^^_^_^^_^X	m
Vbique properas, saeua: me solam times	u&bi_qve^ pro^pe^ra&s s[ae]va^ me_ so&la&m ti^me&s 	X_^^^X_^_X_^X	0.0
Vitasque, gladios inter ac tela et faces	vi&ta_sqve^ gla^di^o&s i_nte^r a&c te&la& e&t fa^ce&s 	X_^^^X_^_X_^X	0.98
Quaesita tota nocte, cupientem fugis.	qv[ae]si_ta^ to_ta& no_cte^ cu^pi^e&nte&m fu^gi&s 	X_^_X_^^^X_^X	1.0
Non hostis aut ruina, non ignis meos	no&n ho_sti^s [au]t ru&i_na^ no_n i&gni&s me^o&s 	X_^_X_^_X_^X	0.93
Absumpsit artus: quam prope a Priamo steti.	a&bsu_mpsi^t a_rtu&s qva&m pro^pe& a& pri^a^mo& ste^ti& 	X_^_X_^_^^_^X	1.0
Repetite celeri maria, captiuae, gradu:	re&pe^ti^te^ ce^le^ri& ma^ri^a^ ca_pti&v[ae] gra^du&	X^^^^^X^^^_X_^X	m
Iam uela puppis laxat et classis mouet.	ja&m ve_la^ pu_ppi&s la_xa^t e&t cla&ssi&s mo^ve&t 	X_^_X_^_X_^X	1.0
